一	横
丁	横,竖钩
七	横,竖弯钩
万	横,横折钩,撇
丈	横,撇,捺
三	横,横,横
上	竖,横,横
下	横,竖,点
不	横,撇,竖,点
与	横,竖折折钩,横
丏	
丐	横,竖,横,竖折折钩
丑	横折,竖,横,横
专	横,横,竖折撇|竖折折,点
且	竖,横折,横,横,横
丕	横,撇,竖,点,横
世	横,竖,竖,横,竖弯
丘	撇,竖,横,竖,横
丙	横,竖,横折钩,撇,点
业	竖,竖,点,撇,横
丛	撇,点,撇,捺,横
东	横,撇折,竖钩,撇,点
丝	撇折,撇折,撇折,撇折,横
丞	横撇|横钩,竖钩,横撇|横钩,撇,捺,横
丢	撇,横,竖,横,撇折,点
两	横,竖,横折钩,撇,点,撇,点
严	横,竖,竖,点,撇,横,撇
丧	横,竖,点,撇,横,竖提,撇,捺
个	撇,捺,竖
丫	点,撇,竖
中	竖,横折,横,竖
丰	横,横,横,竖
串	竖,横折,横,竖,横折,横,竖
临	竖,竖,撇,横,点,竖,横折,竖,横
丸	撇,横斜钩,点
丹	撇,横折钩,点,横
为	点,撇,横折钩,点
主	点,横,横,竖,横
丽	横,竖,横折钩,点,竖,横折钩,点
举	点,点,撇,横,撇,捺,横,横,竖
乂	撇,捺
乃	横折折折钩|横撇弯钩,撇
久	撇,横撇|横钩,捺
么	撇,撇折,点
义	点,撇,捺
之	点,横撇|横钩,捺
乌	撇,横折钩,竖折折钩,横
乍	撇,横,竖,横,横
乎	撇,点,撇,横,竖钩
乏	撇,点,横撇|横钩,捺
乐	撇,竖弯,竖钩,撇,点
乒	撇,竖,横,竖,横,撇
乓	撇,竖,横,竖,横,点
乔	撇,横,撇,捺,撇,竖
乖	撇,横,竖,竖,横,提,撇,竖弯钩
乘	撇,横,竖,竖,横,提,撇,竖弯钩,撇,捺
乙	横斜钩
乜	横折钩,竖弯钩
九	撇,横斜钩
乞	撇,横,横斜钩
也	横折钩,竖,竖弯钩
习	横折钩,点,提
乡	撇折,撇折,撇
书	横折,横折钩,竖,点
乩	竖,横,竖,横折,横,竖弯钩
买	横撇|横钩,点,点,横,撇,点
乱	撇,横,竖,竖,横折,横,竖弯钩
乳	撇,点,点,撇,横撇|横钩,竖钩,提,竖弯钩
乸	
乾	横,竖,竖,横折,横,横,横,竖,撇,横,横斜钩
了	横撇|横钩,竖钩
予	横撇|横钩,点,横撇|横钩,竖钩
争	撇,横撇|横钩,横折,横,横,竖钩
事	横,竖,横折,横,横折,横,横,竖钩
二	横,横
亍	横,横,竖钩
于	横,横,竖钩
亏	横,横,竖折折钩
云	横,横,撇折,点
互	横,撇折,横撇|横钩,横
亓	横,横,撇,竖
五	横,竖,横折,横
井	横,横,撇,竖
亘	横,竖,横折,横,横,横
亚	横,竖,竖,点,撇,横
些	竖,横,竖,提,撇,竖弯钩,横,横
亟	横撇|横钩,竖钩,竖,横折,横,横撇|横钩,点,横
亡	点,横,竖弯
亢	点,横,撇,横斜钩
交	点,横,撇,点,撇,捺
亥	点,横,撇折,撇,撇,点
亦	点,横,撇,竖钩,撇,点
产	点,横,点,撇,横,撇
亨	点,横,竖,横折,横,横撇|横钩,竖钩
亩	点,横,竖,横折,横,竖,横
享	点,横,竖,横折,横,横撇|横钩,竖钩,横
京	点,横,竖,横折,横,竖钩,撇,点
亭	点,横,竖,横折,横,点2,横撇|横钩,横,竖钩
亮	点,横,竖,横折,横,点2,横撇|横钩,撇,横斜钩
亲	点,横,点,撇,横,横,竖钩,撇,点
亳	点,横,竖,横折,横,点2,横撇|横钩,撇,横,竖弯钩
亵	点,横,横,竖钩,提,撇,横斜钩,点,撇,竖提,撇,捺
亶	
亸	
亹	
人	撇,捺
亿	撇,竖,横斜钩
什	撇,竖,横,竖
仁	撇,竖,横,横
仂	撇,竖,横折钩,撇
仃	撇,竖,横,竖钩
仄	横,撇,撇,捺
仅	撇,竖,横撇|横钩,捺
仆	撇,竖,竖,点
仇	撇,竖,撇,横斜钩
仉	撇,竖,撇,横斜钩
今	撇,捺,点,横撇|横钩
介	撇,捺,撇,竖
仍	撇,竖,横折折折钩|横撇弯钩,撇
从	撇,点,撇,捺
仑	撇,捺,撇,竖弯钩
仓	撇,捺,横折钩,竖弯钩
仔	撇,竖,横撇|横钩,竖钩,横
仕	撇,竖,横,竖,横
他	撇,竖,横折钩,竖,竖弯钩
仗	撇,竖,横,撇,捺
付	撇,竖,横,竖钩,点
仙	撇,竖,竖,竖弯,竖
仝	撇,捺,横,竖,横
仞	撇,竖,横折钩,撇,点2
仟	撇,竖,撇,横,竖
仡	撇,竖,撇,横,横斜钩
代	撇,竖,横,斜钩|卧钩,点
令	撇,捺,点,横撇|横钩,点
以	竖提,点,撇,点
仨	撇,竖,横,横,横
仪	撇,竖,点,撇,捺
仫	撇,竖,撇,撇折,点
们	撇,竖,点,竖,横折钩
仰	撇,竖,撇,竖提,横折钩,竖
仲	撇,竖,竖,横折,横,竖
仳	撇,竖,横,竖提,撇,竖弯钩
仵	撇,竖,撇,横,横,竖
件	撇,竖,撇,横,横,竖
价	撇,竖,撇,捺,撇,竖
任	撇,竖,撇,横,竖,横
份	撇,竖,撇,捺,横折钩,撇
仿	撇,竖,点,横,横折钩,撇
企	撇,捺,竖,横,竖,横
伈	
伉	撇,竖,点,横,撇,横斜钩
伊	撇,竖,横折,横,横,撇
伋	
伍	撇,竖,横,竖,横折,横
伎	撇,竖,横,竖,横撇|横钩,捺
伏	撇,竖,横,撇,捺,点
伐	撇,竖,横,斜钩|卧钩,撇,点
休	撇,竖,横,竖,撇,捺
众	撇,捺,撇,点,撇,捺
优	撇,竖,横,撇,竖弯钩,点
伙	撇,竖,点2,撇,撇,捺
会	撇,捺,横,横,撇折,点
伛	撇,竖,横,撇,点,竖弯
伞	撇,捺,点,撇,横,竖
伟	撇,竖,横,横,横折钩,竖
传	撇,竖,横,横,竖折撇|竖折折,点
伢	撇,竖,横,撇折,竖钩,撇
伣	
伤	撇,竖,撇,横,横折钩,撇
伥	撇,竖,撇,横,竖提,捺
伦	撇,竖,撇,捺,撇,竖弯钩
伧	撇,竖,撇,捺,横折钩,竖弯钩
伪	撇,竖,点,撇,横折钩,点
伫	撇,竖,点,点2,横撇|横钩,横
伭	
伯	撇,竖,撇,竖,横折,横,横
估	撇,竖,横,竖,竖,横折,横
伲	撇,竖,横折,横,撇,撇,竖弯钩
伴	撇,竖,点,撇,横,横,竖
伶	撇,竖,撇,捺,点,横撇|横钩,点
伸	撇,竖,竖,横折,横,横,竖
伺	撇,竖,横折钩,横,竖,横折,横
似	撇,竖,竖提,点,撇,点
伽	撇,竖,横折钩,撇,竖,横折,横
伾	
佁	
佃	撇,竖,竖,横折,横,竖,横
但	撇,竖,竖,横折,横,横,横
位	撇,竖,点,横,点,撇,横
低	撇,竖,撇,竖提,横,斜钩|卧钩,点
住	撇,竖,点,横,横,竖,横
佐	撇,竖,横,撇,横,竖,横
佑	撇,竖,横,撇,竖,横折,横
体	撇,竖,横,竖,撇,捺,横
何	撇,竖,横,竖,横折,横,竖钩
佖	
佗	撇,竖,点,点2,横撇|横钩,撇,竖弯钩
佘	撇,捺,横,横,竖钩,撇,点
余	撇,捺,横,横,竖钩,撇,点
佚	撇,竖,撇,横,横,撇,捺
佛	撇,竖,横折,横,竖折折钩,撇,竖
作	撇,竖,撇,横,竖,横,横
佝	撇,竖,撇,横折钩,竖,横折,横
佞	撇,竖,横,横,撇点,撇,横
佟	撇,竖,撇,横撇|横钩,捺,点,点
你	撇,竖,撇,横撇|横钩,竖钩,撇,点
佣	撇,竖,撇,横折钩,横,横,竖
佤	撇,竖,横,竖提,横斜钩,点
佥	撇,捺,横,点,点,撇,横
佩	撇,竖,撇,横斜钩,横,竖,横折钩,竖
佬	撇,竖,横,竖,横,撇,撇,竖弯钩
佯	撇,竖,点,撇,横,横,横,竖
佰	撇,竖,横,撇,竖,横折,横,横
佳	撇,竖,横,竖,横,横,竖,横
佴	撇,竖,横,竖,竖,横,横,横
佶	撇,竖,横,竖,横,竖,横折,横
佸	
佺	撇,竖,撇,捺,横,横,竖,横
佻	撇,竖,撇,点,提,竖弯钩,撇,点
佼	撇,竖,点,横,撇,点,撇,捺
佽	
佾	撇,竖,撇,捺,竖,横折钩,横,横
使	撇,竖,横,竖,横折,横,撇,捺
侁	
侂	
侃	撇,竖,竖,横折,横,撇,竖,竖弯钩
侄	撇,竖,横,撇折,点,横,竖,横
侈	撇,竖,撇,横撇|横钩,点,撇,横撇|横钩,点
侉	撇,竖,横,撇,捺,横,横,竖折折钩
例	撇,竖,横,撇,横撇|横钩,点,竖,竖钩
侍	撇,竖,横,竖,横,横,竖钩,点
侏	撇,竖,撇,横,横,竖,撇,捺
侑	撇,竖,横,撇,竖,横折钩,横,横
侔	撇,竖,撇折,点,撇,横,横,竖
侗	撇,竖,竖,横折钩,横,竖,横折,横
侘	
供	撇,竖,横,竖,竖,横,撇,点
依	撇,竖,点,横,撇,竖提,撇,捺
侠	撇,竖,横,点,撇,横,撇,捺
侣	撇,竖,竖,横折,横,竖,横折,横
侥	撇,竖,横,斜钩|卧钩,撇,横,撇,竖弯钩
侦	撇,竖,竖,横,竖,横折,撇,点
侧	撇,竖,竖,横折,撇,点,竖,竖钩
侨	撇,竖,撇,横,撇,捺,撇,竖
侩	撇,竖,撇,捺,横,横,撇折,点
侪	撇,竖,点,横,撇,捺,撇,竖
侬	撇,竖,点2,横撇|横钩,撇,竖提,撇,捺
侮	撇,竖,撇,横,竖弯,横折钩,点,横,点
侯	撇,竖,横折,横,撇,横,横,撇,捺
侴	
侵	撇,竖,横折,横,横,点2,横撇|横钩,横撇|横钩,捺
侹	
便	撇,竖,横,竖,横折,横,横,撇,捺
促	撇,竖,竖,横折,横,竖,横,撇,捺
俄	撇,竖,撇,横,竖钩,提,斜钩|卧钩,撇,点
俅	撇,竖,横,竖钩,点,提,撇,捺,点
俊	撇,竖,撇折,点,撇,点,撇,横撇|横钩,捺
俍	
俎	撇,点,撇,点,竖,横折,横,横,横
俏	撇,竖,竖,点,撇,竖,横折钩,横,横
俐	撇,竖,撇,横,竖,撇,点,竖,竖钩
俑	撇,竖,横撇|横钩,点,竖,横折钩,横,横,竖
俗	撇,竖,撇,点,撇,捺,竖,横折,横
俘	撇,竖,撇,点,点,撇,横撇|横钩,竖钩,横
俙	
俚	撇,竖,竖,横折,横,横,竖,横,横
俜	撇,竖,竖,横折,横,竖,横,横,竖折折钩
保	撇,竖,竖,横折,横,横,竖,撇,捺
俞	撇,捺,横,竖,横折钩,横,横,竖,竖钩
俟	撇,竖,撇折,点,撇,横,横,撇,捺
信	撇,竖,点,横,横,横,竖,横折,横
俣	撇,竖,竖,横折,横,横,横,撇,捺
俦	撇,竖,横,横,横,撇,横,竖钩,点
俨	撇,竖,横,竖,竖,点,撇,横,撇
俩	撇,竖,横,竖,横折钩,撇,点,撇,点
俪	撇,竖,横,竖,横折钩,点,竖,横折钩,点
俫	
俭	撇,竖,撇,捺,横,点,点,撇,横
修	撇,竖,竖,撇,横撇|横钩,捺,撇,撇,撇
俯	撇,竖,点,横,撇,撇,竖,横,竖钩,点
俱	撇,竖,竖,横折,横,横,横,横,撇,点
俳	撇,竖,竖,横,横,横,竖,横,横,横
俵	
俶	撇,竖,竖,横,横,竖钩,撇,点,横撇|横钩,捺
俸	撇,竖,横,横,横,撇,捺,横,横,竖
俺	撇,竖,横,撇,捺,竖,横折,横,横,竖弯钩
俾	撇,竖,撇,竖,横折,横,横,撇,横,竖
倌	撇,竖,点,点2,横撇|横钩,竖,横折,横,横折,横
倍	撇,竖,点,横,点,撇,横,竖,横折,横
倏	撇,竖,竖,撇,横撇|横钩,捺,横,撇,点,点
倒	撇,竖,横,撇折,点,横,竖,提,竖,竖钩
倓	撇,竖,点2,撇,撇,点,点2,撇,撇,捺
倔	撇,竖,横折,横,撇,竖弯,竖,竖,竖弯,竖
倕	
倘	撇,竖,竖,点,撇,竖,横折钩,竖,横折,横
候	撇,竖,竖,横折,横,撇,横,横,撇,捺
倚	撇,竖,横,撇,点,横,竖,横折,横,竖钩
倜	撇,竖,撇,横折钩,横,竖,横,竖,横折,横
倞	
借	撇,竖,横,竖,竖,横,竖,横折,横,横
倡	撇,竖,竖,横折,横,横,竖,横折,横,横
倥	撇,竖,点,点2,横撇|横钩,撇,点,横,竖,横
倦	撇,竖,点,撇,横,横,撇,捺,横折钩,竖弯钩
倧	
倨	撇,竖,横折,横,撇,横,竖,竖,横折,横
倩	撇,竖,横,横,竖,横,竖,横折钩,横,横
倪	撇,竖,撇,竖,横,横折,横,横,撇,竖弯钩
倬	撇,竖,竖,横,竖,横折,横,横,横,竖
倭	撇,竖,撇,横,竖,撇,捺,撇点,撇,横
倮	撇,竖,竖,横折,横,横,横,竖,撇,捺
倴	
债	撇,竖,横,横,竖,横,竖,横折,撇,点
倻	
值	撇,竖,横,竖,竖,横折,横,横,横,横
倾	撇,竖,横,竖提,横,撇,竖,横折,撇,点
偁	
偃	撇,竖,横,竖,横折,横,横,撇点,撇,横,竖弯
假	撇,竖,横折,横,竖,横,横,横折,横,横撇|横钩,捺
偈	撇,竖,竖,横折,横,横,撇,横折钩,撇,点,竖弯
偌	撇,竖,横,竖,竖,横,撇,竖,横折,横
偎	撇,竖,竖,横折,横,竖,横,横,竖提,撇,捺
偏	撇,竖,点,横折,横,撇,竖,横折钩,横,竖,竖
偓	
偕	撇,竖,横,竖提,撇,竖弯钩,撇,竖,横折,横,横
做	撇,竖,横,竖,竖,横折,横,撇,横,撇,捺
停	撇,竖,点,横,竖,横折,横,点2,横撇|横钩,横,竖钩
偡	
健	撇,竖,横折,横,横,横,横,竖,横折折撇,捺
偬	撇,竖,撇,横折钩,撇,撇,点,点2,斜钩|卧钩,点,点
偭	
偰	
偲	撇,竖,竖,横折,横,竖,横,点2,斜钩|卧钩,点,点
偶	撇,竖,竖,横折,横,横,竖,横折钩,竖,提,点
偷	撇,竖,撇,捺,横,竖,横折钩,横,横,竖,竖钩
偻	撇,竖,点,撇,横,竖,撇,捺,撇点,撇,横
偾	撇,竖,横,竖,横,竖,竖,竖,横折,撇,点
偿	撇,竖,竖,点,撇,点2,横撇|横钩,横,横,撇折,点
傀	撇,竖,撇,竖,横折,横,横,撇,竖弯钩,撇折,点
傃	
傅	撇,竖,横,竖,横折,横,横,竖,点,横,竖钩,点
傈	撇,竖,横,竖,横折,竖,竖,横,横,竖,撇,捺
傉	
傍	撇,竖,点,横,点,撇,点2,横撇|横钩,点,横,横折钩,撇
傒	
傕	
傣	撇,竖,横,横,横,撇,捺,竖钩,点,提,撇,点
傥	撇,竖,竖,点,撇,点2,横撇|横钩,竖,横折,横,撇,竖弯钩
傧	撇,竖,点,点2,横撇|横钩,撇,竖,横,竖,横,撇,点
储	撇,竖,点,横折提,横,竖,横,撇,竖,横折,横,横
傩	撇,竖,横撇|横钩,点,撇,竖,点,横,横,横,竖,横
催	撇,竖,竖,竖弯,竖,撇,竖,点,横,横,横,竖,横
傲	撇,竖,横,横,竖,横,横折钩,撇,撇,横,撇,捺
傺	撇,竖,撇,横撇|横钩,点,点,横撇|横钩,捺,横,横,竖钩,撇,点
傻	撇,竖,撇,竖,横折,撇,点,横,撇,点,撇,横撇|横钩,捺
僇	
僎	
像	撇,竖,撇,横撇|横钩,竖,横折,横,撇,弯钩,撇,撇,撇,捺
僔	
僖	撇,竖,横,竖,横,竖,横折,横,点,撇,横,竖,横折,横
僚	撇,竖,横,撇,捺,点,撇,竖,横折,横,横,竖钩,撇,点
僦	撇,竖,点,横,竖,横折,横,竖钩,撇,点,横,撇,竖弯钩,点
僧	撇,竖,点,撇,竖,横折,竖,点,撇,横,竖,横折,横,横
僬	撇,竖,撇,竖,点,横,横,横,竖,横,点2,点,点,点
僭	撇,竖,横,撇折,撇,竖提,横,撇折,撇,竖弯钩,竖,横折,横,横
僮	撇,竖,点,横,点,撇,横,竖,横折,横,横,竖,横,横
僰	横,竖,横折,竖,撇,点,横,竖,横折,竖,撇,点,撇,捺
僳	撇,竖,横,竖,横折,竖,竖,横,点,撇,横,竖,撇,捺
僵	撇,竖,横,竖,横折,横,竖,横,横,竖,横折,横,竖,横,横
僻	撇,竖,横折,横,撇,竖,横折,横,点,横,点,撇,横,横,竖
儆	撇,竖,横,竖,竖,撇,横折钩,竖,横折,横,撇,横,撇,捺
儇	撇,竖,竖,横折,竖,竖,横,横,竖,横折,横,撇,竖提,撇,捺
儋	撇,竖,撇,横撇|横钩,横,撇,撇,点,点,横,横,横,竖,横折,横
儒	撇,竖,横,点2,横撇|横钩,竖,点,点,点,点,横,撇,竖,横折钩,竖,竖
儡	撇,竖,竖,横折,横,竖,横,竖,横折,横,竖,横,竖,横折,横,竖,横
儦	
儳	
儴	
儿	撇,竖弯钩
兀	横,撇,竖弯钩
允	撇折,点,撇,竖弯钩
元	横,横,撇,竖弯钩
兄	竖,横折,横,撇,竖弯钩
充	点,横,撇折,点,撇,竖弯钩
兆	撇,点,提,竖弯钩,撇,点
先	撇,横,竖,横,撇,竖弯钩
光	竖,点,撇,横,撇,竖弯钩
克	横,竖,竖,横折,横,撇,竖弯钩
免	撇,横撇|横钩,竖,横折,横,撇,竖弯钩
兑	点,撇,竖,横折,横,撇,竖弯钩
兔	撇,横撇|横钩,竖,横折,横,撇,竖弯钩,点
兕	竖,横折折|横折弯,竖,横折,横,撇,竖弯钩
兖	点,横,撇,点,撇折,点,撇,竖弯钩
党	竖,点,撇,点2,横撇|横钩,竖,横折,横,撇,竖弯钩
兜	撇,竖,横折,横,横,撇,竖提,横折,横,撇,竖弯钩
兢	横,竖,竖,横折,横,撇,竖提,横,竖,竖,横折,横,撇,竖弯钩
入	撇,捺
全	撇,捺,横,横,竖,横
八	撇,捺
公	撇,捺,撇折,点
六	点,横,撇,点
兮	撇,捺,横,竖折折钩
兰	点,撇,横,横,横
共	横,竖,竖,横,撇,点
关	点,撇,横,横,撇,捺
兴	点,点,撇,横,撇,点
兵	撇,竖,横,竖,横,撇,点
其	横,竖,竖,横,横,横,撇,点
具	竖,横折,横,横,横,横,撇,点
典	竖,横折,横,竖,竖,横,撇,点
兹	点,撇,横,撇折,撇折,点,撇折,撇折,点
养	点,撇,横,横,横,撇,捺,撇,竖
兼	点,撇,横,横折,横,横,竖,竖,撇,捺
兽	点,撇,竖,横折,横,竖,横,横,竖,横折,横
冀	竖,横,提,撇,竖弯钩,竖,横折,横,竖,横,横,竖,竖,横,撇,点
冁	点,撇,竖,横折,横,横,横,竖,横折,横,撇,横,竖,竖,横,竖提,撇,捺
内	竖,横折钩,撇,点
冈	竖,横折钩,撇,点
冉	竖,横折钩,竖,横,横
册	撇,横折钩,撇,横折钩,横
再	横,竖,横折钩,竖,横,横
冏	
冒	竖,横折,横,横,竖,横折,横,横,横
冔	
冕	竖,横折,横,横,撇,横撇|横钩,竖,横折,横,撇,竖弯钩
冗	点2,横撇|横钩,撇,横斜钩
写	点2,横撇|横钩,横,竖折折钩,横
军	点2,横撇|横钩,横,撇折,横,竖
农	点2,横撇|横钩,撇,竖提,撇,捺
冠	点2,横撇|横钩,横,横,撇,竖弯钩,横,竖钩,点
冢	点2,横撇|横钩,横,撇,弯钩,撇,撇,点,撇,捺
冤	点2,横撇|横钩,撇,横撇|横钩,竖,横折,横,撇,竖弯钩,点
冥	点2,横撇|横钩,竖,横折,横,横,点,横,撇,点
冬	撇,横撇|横钩,捺,点,点
冮	
冯	点,提,横折,竖折折钩,横
冰	点,提,竖钩,横撇|横钩,撇,捺
冱	点,提,横,撇折,横撇|横钩,横
冲	点,提,竖,横折,横,竖
决	点,提,横折,横,撇,捺
况	点,提,竖,横折,横,撇,竖弯钩
冶	点,提,撇折,点,竖,横折,横
冷	点,提,撇,捺,点,横撇|横钩,点
冻	点,提,横,撇折,竖钩,撇,点
冼	点,提,撇,横,竖,横,撇,竖弯钩
冽	点,提,横,撇,横撇|横钩,点,竖,竖钩
净	点,提,撇,横撇|横钩,横折,横,横,竖钩
凄	点,提,横,横折,横,横,竖,撇点,撇,横
准	点,提,撇,竖,点,横,横,横,竖,横
凇	点,提,横,竖,撇,点,撇,捺,撇折,点
凉	点,提,点,横,竖,横折,横,竖钩,撇,点
凋	点,提,撇,横折钩,横,竖,横,竖,横折,横
凌	点,提,横,竖,横,撇,点,撇,横撇|横钩,捺
减	点,提,横,撇,横,竖,横折,横,斜钩|卧钩,撇,点
凑	点,提,横,横,横,撇,捺,横,横,撇,点
凓	
凘	
凛	点,提,点,横,竖,横折,竖,横折,横,横,横,横,竖钩,撇,点
凝	点,提,撇,竖弯钩,撇,横,横,撇,点,横撇|横钩,点,横撇|横钩,竖,横,撇,捺
几	撇,横斜钩
凡	撇,横斜钩,点
凤	撇,横斜钩,横撇|横钩,点
凫	撇,横折钩,点,竖折折钩,撇,横斜钩
凭	撇,竖,撇,横,竖,横,撇,横斜钩
凯	竖,竖弯,竖,横折,横,竖提,撇,横斜钩
凰	撇,横斜钩,撇,竖,横折,横,横,横,横,竖,横
凳	横撇|横钩,点,撇,撇,捺,横,竖,横折,横,点,撇,横,撇,横斜钩
凶	撇,点,竖弯,竖
凸	竖,横,竖,横折折折,横
凹	竖,横折折|横折弯,竖,横折,横
出	竖弯,竖,竖,竖弯,竖
击	横,横,竖,竖弯,竖
凼	竖钩,横撇|横钩,撇,点,竖弯,竖
函	横撇|横钩,竖钩,点,提,撇,点,竖弯,竖
凿	竖,竖,点,撇,横,点,撇,横,横,竖,竖弯,竖
刀	横折钩,撇
刁	横折钩,提
刃	横折钩,撇,点2
分	撇,捺,横折钩,撇
切	横,竖提,横折钩,撇
刈	撇,点,竖,竖钩
刊	横,横,竖,竖,竖钩
刍	撇,横撇|横钩,横折,横,横
刎	撇,横折钩,撇,撇,竖,竖钩
刑	横,横,撇,竖,竖,竖钩
划	横,斜钩|卧钩,撇,点,竖,竖钩
刖	撇,横折钩,横,横,竖,竖钩
列	横,撇,横撇|横钩,点,竖,竖钩
刘	点,横,撇,点,竖,竖钩
则	竖,横折,撇,点,竖,竖钩
刚	竖,横折钩,撇,点,竖,竖钩
创	撇,点,横折钩,竖弯钩,竖,竖钩
初	点,横撇|横钩,竖,撇,点,横折钩,撇
删	撇,横折钩,撇,横折钩,横,竖,竖钩
判	点,撇,横,横,撇,竖,竖钩
刨	撇,横折钩,横折,横,竖弯钩,竖,竖钩
利	撇,横,竖,撇,点,竖,竖钩
别	竖,横折,横,横折钩,撇,竖,竖钩
刬	
刭	横撇|横钩,点,横,竖,提,竖,竖钩
刮	撇,横,竖,竖,横折,横,竖,竖钩
到	横,撇折,点,横,竖,提,竖,竖钩
刳	横,撇,点,横,横,竖折折钩,竖,竖钩
制	撇,横,横,竖,横折钩,竖,竖,竖钩
刷	横折,横,撇,竖,横折钩,竖,竖,竖钩
券	点,撇,横,横,撇,捺,横折钩,撇
刹	撇,点,横,竖钩,撇,点,竖,竖钩
刺	横,竖,横折钩,竖,撇,点,竖,竖钩
刻	点,横,撇折,撇,撇,点,竖,竖钩
刽	撇,点,横,横,撇折,点,竖,竖钩
刿	竖,竖弯,竖,撇,横撇|横钩,点,竖,竖钩
剀	竖,竖弯,竖,横折,横,竖提,竖,竖钩
剁	撇,横折折|横折弯,横,竖,撇,点,竖,竖钩
剂	点,横,撇,点,撇,竖,竖,竖钩
剃	点,撇,横折,横,竖折折钩,竖,撇,竖,竖钩
剅	
削	竖,点,撇,竖,横折钩,横,横,竖,竖钩
剋	横,竖,竖,横折,横,撇,竖弯钩,竖,竖钩
剌	横,竖,横折,横,竖,撇,点,竖,竖钩
前	点,撇,横,竖,横折钩,横,横,竖,竖钩
剐	竖,横折,横,竖,横折钩,撇,点,竖,竖钩
剑	撇,点,横,点,点,撇,提,竖,竖钩
剔	竖,横折,横,横,撇,横折钩,撇,撇,竖,竖钩
剕	
剖	点,横,点,撇,横,竖,横折,横,竖,竖钩
剜	点,点2,横撇|横钩,撇,横撇|横钩,点,横折钩,竖提,竖,竖钩
剞	横,撇,点,横,竖,横折,横,竖钩,竖,竖钩
剟	
剡	点2,撇,撇,点,点2,撇,撇,点,竖,竖钩
剥	横折,横,横,竖钩,点,提,撇,点,竖,竖钩
剧	横折,横,撇,横,竖,竖,横折,横,竖,竖钩
剩	撇,横,竖,竖,横,提,撇,竖弯钩,撇,点,竖,竖钩
剪	点,撇,横,竖,横折钩,横,横,竖,竖钩,横折钩,撇
副	横,竖,横折,横,竖,横折,横,竖,横,竖,竖钩
割	点,点2,横撇|横钩,横,横,横,竖,竖,横折,横,竖,竖钩
剽	横,竖,横折,竖,竖,横,横,横,竖钩,撇,点,竖,竖钩
剿	撇点,撇点,撇点,竖,横折,横,横,横,竖,撇,点,竖,竖钩
劁	撇,竖,点,横,横,横,竖,横,点2,点,点,点,竖,竖钩
劂	横,撇,点,撇,横,竖弯,竖,撇,撇,横撇|横钩,撇,点,竖,竖钩
劄	撇,横,点,撇,横,点,撇,点,横,竖,横折,横,竖,竖钩
劈	横折,横,撇,竖,横折,横,点,横,点,撇,横,横,竖,横折钩,撇
劐	横,竖,竖,撇,竖,点,横,横,横,竖,横,横撇|横钩,点,竖,竖钩
劓	撇,竖,横折,横,横,横,竖,横折,横,竖,横,横,撇,竖,竖,竖钩
力	横折钩,撇
劝	横撇|横钩,点,横折钩,撇
办	横折钩,撇,点2,点
功	横,竖,提,横折钩,撇
加	横折钩,撇,竖,横折,横
务	撇,横撇|横钩,捺,横折钩,撇
劢	横,横折钩,撇,横折钩,撇
劣	竖,撇,点,撇,横折钩,撇
动	横,横,撇折,点,横折钩,撇
助	竖,横折,横,横,提,横折钩,撇
努	撇点,撇,横,横撇|横钩,捺,横折钩,撇
劫	横,竖,横,撇折,点,横折钩,撇
劬	撇,横折钩,竖,横折,横,横折钩,撇
劭	横折钩,撇,竖,横折,横,横折钩,撇
励	横,撇,横,横折钩,撇,横折钩,撇
劲	横撇|横钩,点,横,竖,提,横折钩,撇
劳	横,竖,竖,点2,横撇|横钩,横折钩,撇
劼	横,竖,横,竖,横折,横,横折钩,撇
劾	点,横,撇折,撇,撇,点,横折钩,撇
势	横,竖钩,提,撇,横斜钩,点,横折钩,撇
勃	横,竖,点2,横撇|横钩,横撇|横钩,竖钩,提,横折钩,撇
勇	横撇|横钩,点,竖,横折,横,横,竖,横折钩,撇
勉	撇,横撇|横钩,竖,横折,横,撇,竖弯钩,横折钩,撇
勋	竖,横折,横,竖,横折,撇,点,横折钩,撇
勍	
勐	横撇|横钩,竖钩,横,竖,横折,竖,竖,提,横折钩,撇
勒	横,竖,竖,横,竖,横折,横,横,竖,横折钩,撇
勔	
勖	竖,横折,横,横,竖,横折,横,横,横,横折钩,撇
勘	横,竖,竖,横,横,横,撇,点,竖弯,横折钩,撇
勚	
募	横,竖,竖,竖,横折,横,横,横,撇,捺,横折钩,撇
勠	横折,点,提,横折,点,提,撇,点,撇,撇,撇,横折钩,撇
勤	横,竖,竖,横,竖,横折,横,横,横,竖,提,横折钩,撇
勰	横折钩,撇,横折钩,撇,横折钩,撇,竖,横折,横,竖,横,点2,斜钩|卧钩,点,点
勺	撇,横折钩,点
勾	撇,横折钩,撇折,点
勿	撇,横折钩,撇,撇
匀	撇,横折钩,点,提
包	撇,横折钩,横折,横,竖弯钩
匆	撇,横折钩,撇,撇,点
匈	撇,横折钩,撇,点,竖弯,竖
匍	撇,横折钩,横,竖,横折钩,横,横,竖,点
匏	横,撇,点,横,横,竖折折钩,撇,横折钩,横折,横,竖弯钩
匐	撇,横折钩,横,竖,横折,横,竖,横折,横,竖,横
匕	撇,竖弯钩
化	撇,竖,撇,竖弯钩
北	竖,横,提,撇,竖弯钩
匙	竖,横折,横,横,横,竖,横,撇,捺,撇,竖弯钩
匜	
匝	横,竖,横折钩,竖,竖弯
匠	横,撇,撇,横,竖,竖弯
匡	横,横,横,竖,横,竖弯
匣	横,竖,横折,横,横,竖,竖弯
匦	横,横,撇折,竖,提,撇,横斜钩,竖弯
匪	横,竖,横,横,横,竖,横,横,横,竖弯
匮	横,竖,横折,横,竖,横,竖,横折,撇,点,竖弯
匹	横,撇,竖弯钩,竖弯
区	横,撇,点,竖弯
医	横,撇,横,横,撇,点,竖弯
匼	
匾	横,点,横折,横,撇,竖,横折钩,横,竖,竖,竖弯
匿	横,横,竖,竖,横,撇,竖,横折,横,竖弯
十	横,竖
千	撇,横,竖
卅	横,撇,竖,竖
升	撇,横,撇,竖
午	撇,横,横,竖
卉	横,竖,横,撇,竖
半	点,撇,横,横,竖
华	撇,竖,撇,竖弯钩,横,竖
协	横,竖,横折钩,撇,点2,点
卑	撇,竖,横折,横,横,撇,横,竖
卒	点,横,撇,点,撇,点,横,竖
卓	竖,横,竖,横折,横,横,横,竖
单	点,撇,竖,横折,横,横,横,竖
卖	横,竖,横撇|横钩,点,点,横,撇,点
南	横,竖,竖,横折钩,点,撇,横,横,竖
博	横,竖,横,竖,横折,横,横,竖,点,横,竖钩,点
卜	竖,点
卞	点,横,竖,点
卟	竖,横折,横,竖,点
占	竖,横,竖,横折,横
卡	竖,横,横,竖,点
卢	竖,横,横折,横,撇
卣	竖,横,竖,横折,横折,横,横
卤	竖,横,竖,横折,撇,点,横
卦	横,竖,横,横,竖,提,竖,点
卧	横,竖,横折,横,竖,竖弯,竖,点
卫	横折钩,竖,横
卬	
卮	撇,撇,横,横折钩,竖弯钩
卯	撇,竖提,撇,横折钩,竖
印	撇,竖提,横,横折钩,竖
危	撇,横撇|横钩,横,撇,横折钩,竖弯钩
即	横折,横,横,竖提,点,横折钩,竖
却	横,竖,横,撇折,点,横折钩,竖
卵	撇,竖提,点,撇,横折钩,竖,点
卷	点,撇,横,横,撇,捺,横折钩,竖弯钩
卸	撇,横,横,竖,横,竖,提,横折钩,竖
卺	横撇|横钩,竖钩,横撇|横钩,撇,捺,横,横折钩,竖弯钩
卿	撇,竖提,撇,横折,横,横,竖提,点,横折钩,竖
厂	横,撇
厄	横,撇,横折钩,竖弯钩
厅	横,撇,横,竖钩
历	横,撇,横折钩,撇
厉	横,撇,横,横折钩,撇
压	横,撇,横,竖,横,点
厌	横,撇,横,撇,捺,点
厍	横,撇,横,撇折,横,竖
厕	横,撇,竖,横折,撇,点,竖,竖钩
厖	
厘	横,撇,竖,横折,横,横,竖,横,横
厚	横,撇,竖,横折,横,横,横撇|横钩,竖钩,横
厝	横,撇,横,竖,竖,横,竖,横折,横,横
原	横,撇,撇,竖,横折,横,横,竖钩,撇,点
厢	横,撇,横,竖,撇,点,竖,横折,横,横,横
厣	横,撇,横,撇,捺,点,竖,横折,横,横,竖
厥	横,撇,点,撇,横,竖弯,竖,撇,撇,横撇|横钩,撇,捺
厦	横,撇,横,撇,竖,横折,横,横,横,撇,横撇|横钩,捺
厨	横,撇,横,竖,横折,横,点,撇,提,横,竖钩,点
厩	横,撇,横折,横,横,竖提,点,横,撇折,撇,竖弯钩
厮	横,撇,横,竖,竖,横,横,横,撇,点,撇,撇,横,竖
去	横,竖,横,撇折,点
厾	
县	竖,横折,横,横,横,撇折,点
叁	撇折,点,横,撇,捺,横,横,横
参	撇折,点,横,撇,捺,撇,撇,撇
叆	
叇	
又	横撇|横钩,捺
叉	横撇|横钩,捺,点
及	撇,横折折撇,捺
友	横,撇,横撇|横钩,捺
双	横撇|横钩,点,横撇|横钩,捺
反	撇,撇,横撇|横钩,捺
发	撇折,撇,横撇|横钩,捺,点
叔	竖,横,横,竖钩,撇,点,横撇|横钩,捺
叕	横撇|横钩,点,横撇|横钩,点,横撇|横钩,点,横撇|横钩,捺
取	横,竖,竖,横,横,提,横撇|横钩,捺
受	撇,点,点,撇,点2,横撇|横钩,横撇|横钩,捺
变	点,横,竖,竖,撇,点,横撇|横钩,捺
叙	撇,点,横,横,竖钩,撇,点,横撇|横钩,捺
叚	
叛	点,撇,横,横,撇,撇,撇,横撇|横钩,捺
叟	撇,竖,横,横折,横,横,竖,横撇|横钩,捺
叠	横撇|横钩,点,横撇|横钩,点,横撇|横钩,点,点2,横撇|横钩,竖,横折,横,横,横
口	竖,横折,横
古	横,竖,竖,横折,横
句	撇,横折钩,竖,横折,横
另	竖,横折,横,横折钩,撇
叨	竖,横折,横,横折钩,撇
叩	竖,横折,横,横折钩,竖
只	竖,横折,横,撇,点
叫	竖,横折,横,竖提,竖
召	横折钩,撇,竖,横折,横
叭	竖,横折,横,撇,捺
叮	竖,横折,横,横,竖钩
可	横,竖,横折,横,竖钩
台	撇折,点,竖,横折,横
叱	竖,横折,横,撇,竖弯钩
史	竖,横折,横,撇,捺
右	横,撇,竖,横折,横
叵	横,竖,横折,横,竖弯
叶	竖,横折,横,横,竖
号	竖,横折,横,横,竖折折钩
司	横折钩,横,竖,横折,横
叹	竖,横折,横,横撇|横钩,捺
叻	竖,横折,横,横折钩,撇
叼	竖,横折,横,横折钩,提
叽	竖,横折,横,撇,横斜钩
吁	竖,横折,横,横,横,竖钩
吃	竖,横折,横,撇,横,横斜钩
各	撇,横撇|横钩,捺,竖,横折,横
吆	竖,横折,横,撇折,撇折,点
合	撇,捺,横,竖,横折,横
吉	横,竖,横,竖,横折,横
吊	竖,横折,横,竖,横折钩,竖
同	竖,横折钩,横,竖,横折,横
名	撇,横撇|横钩,点,竖,横折,横
后	撇,撇,横,竖,横折,横
吏	横,竖,横折,横,撇,捺
吐	竖,横折,横,横,竖,横
向	撇,竖,横折钩,竖,横折,横
吒	竖,横折,横,撇,横,竖弯钩
吓	竖,横折,横,横,竖,点
吕	竖,横折,横,竖,横折,横
吖	竖,横折,横,点,撇,竖
吗	竖,横折,横,横折,竖折折钩,横
君	横折,横,横,撇,竖,横折,横
吝	点,横,撇,捺,竖,横折,横
吞	横,横,撇,捺,竖,横折,横
吟	竖,横折,横,撇,捺,点,横撇|横钩
吠	竖,横折,横,横,撇,捺,点
吡	竖,横折,横,横,竖提,撇,竖弯钩
吣	竖,横折,横,点2,斜钩|卧钩,点,点
否	横,撇,竖,点,竖,横折,横
吧	竖,横折,横,横折,竖,横,竖弯钩
吨	竖,横折,横,横,竖弯,竖,竖弯钩
吩	竖,横折,横,撇,捺,横折钩,撇
含	撇,捺,点,横撇|横钩,竖,横折,横
听	竖,横折,横,撇,撇,横,竖
吭	竖,横折,横,点,横,撇,横斜钩
吮	竖,横折,横,撇折,点,撇,竖弯钩
启	点,横折,横,撇,竖,横折,横
吱	竖,横折,横,横,竖,横撇|横钩,捺
吲	竖,横折,横,横折,横,竖折折钩,竖
吴	竖,横折,横,横,横,撇,捺
吵	竖,横折,横,竖,撇,点,撇
吸	竖,横折,横,撇,横折折撇,捺
吹	竖,横折,横,撇,横撇|横钩,撇,捺
吻	竖,横折,横,撇,横折钩,撇,撇
吼	竖,横折,横,横撇|横钩,竖钩,提,竖弯钩
吽	
吾	横,竖,横折,横,竖,横折,横
呀	竖,横折,横,横,撇折,竖钩,撇
呃	竖,横折,横,横,撇,横折钩,竖弯钩
呆	竖,横折,横,横,竖,撇,捺
呇	
呈	竖,横折,横,横,横,竖,横
告	撇,横,竖,横,竖,横折,横
呋	竖,横折,横,横,横,撇,捺
呐	竖,横折,横,竖,横折钩,撇,点
呒	竖,横折,横,横,横,撇,竖弯钩
呓	竖,横折,横,横,竖,竖,横斜钩
呔	竖,横折,横,横,撇,捺,点
呕	竖,横折,横,横,撇,点,竖弯
呖	竖,横折,横,横,撇,横折钩,撇
呗	竖,横折,横,竖,横折,撇,点
员	竖,横折,横,竖,横折,撇,点
呙	竖,横折,横,竖,横折钩,撇,点
呛	竖,横折,横,撇,捺,横折钩,竖弯钩
呜	竖,横折,横,撇,横折钩,竖折折钩,横
呢	竖,横折,横,横折,横,撇,撇,竖弯钩
呣	
呤	竖,横折,横,撇,捺,点,横撇|横钩,点
呦	竖,横折,横,撇折,撇折,点,横折钩,撇
周	撇,横折钩,横,竖,横,竖,横折,横
呱	竖,横折,横,撇,撇,竖提,点,捺
呲	竖,横折,横,竖,横,竖,提,撇,竖弯钩
味	竖,横折,横,横,横,竖,撇,捺
呵	竖,横折,横,横,竖,横折,横,竖钩
呶	竖,横折,横,撇点,撇,横,横撇|横钩,捺
呷	竖,横折,横,竖,横折,横,横,竖
呸	竖,横折,横,横,撇,竖,点,横
呻	竖,横折,横,竖,横折,横,横,竖
呼	竖,横折,横,撇,点,撇,横,竖钩
命	撇,捺,横,竖,横折,横,横折钩,竖
咀	竖,横折,横,竖,横折,横,横,横
咂	竖,横折,横,横,竖,横折钩,竖,竖弯
咄	竖,横折,横,竖弯,竖,竖,竖弯,竖
咆	竖,横折,横,撇,横折钩,横折,横,竖弯钩
咇	
咉	
咋	竖,横折,横,撇,横,竖,横,横
和	撇,横,竖,撇,点,竖,横折,横
咍	
咎	撇,横撇|横钩,捺,竖,点,竖,横折,横
咏	竖,横折,横,点,横折钩,横撇|横钩,撇,捺
咐	竖,横折,横,撇,竖,横,竖钩,点
咒	竖,横折,横,竖,横折,横,撇,横斜钩
咔	竖,横折,横,竖,横,横,竖,点
咕	竖,横折,横,横,竖,竖,横折,横
咖	竖,横折,横,横折钩,撇,竖,横折,横
咙	竖,横折,横,横,撇,竖弯钩,撇,点
咚	竖,横折,横,撇,横撇|横钩,捺,点,点
咛	竖,横折,横,点,点2,横撇|横钩,横,竖钩
咝	竖,横折,横,撇折,撇折,撇折,撇折,横
咡	
咣	竖,横折,横,竖,点,撇,横,撇,竖弯钩
咤	竖,横折,横,点,点2,横撇|横钩,撇,横,竖弯钩
咥	
咦	竖,横折,横,横,横折,横,竖折折钩,撇,捺
咧	竖,横折,横,横,撇,横撇|横钩,点,竖,竖钩
咨	点,提,撇,横撇|横钩,撇,捺,竖,横折,横
咩	竖,横折,横,点,撇,横,横,横,竖
咪	竖,横折,横,点,撇,横,竖,撇,捺
咫	横折,横,撇,捺,竖,横折,横,撇,点
咬	竖,横折,横,点,横,撇,点,撇,捺
咯	竖,横折,横,撇,横撇|横钩,捺,竖,横折,横
咱	竖,横折,横,撇,竖,横折,横,横,横
咳	竖,横折,横,点,横,撇折,撇,撇,点
咴	竖,横折,横,横,撇,点2,撇,撇,捺
咸	横,撇,横,竖,横折,横,斜钩|卧钩,撇,点
咺	
咻	竖,横折,横,撇,竖,横,竖,撇,捺
咽	竖,横折,横,竖,横折,横,撇,点,横
咿	竖,横折,横,撇,竖,横折,横,横,撇
哀	点,横,竖,横折,横,撇,竖提,撇,捺
品	竖,横折,横,竖,横折,横,竖,横折,横
哂	竖,横折,横,横,竖,横折,撇,竖弯,横
哃	
哄	竖,横折,横,横,竖,竖,横,撇,点
哆	竖,横折,横,撇,横撇|横钩,点,撇,横撇|横钩,点
哇	竖,横折,横,横,竖,横,横,竖,横
哈	竖,横折,横,撇,捺,横,竖,横折,横
哉	横,竖,横,竖,横折,横,斜钩|卧钩,撇,点
哌	竖,横折,横,撇,撇,撇,竖提,撇,捺
响	竖,横折,横,撇,竖,横折钩,竖,横折,横
哎	竖,横折,横,横,竖,竖,撇,捺
哏	竖,横折,横,横折,横,横,竖提,撇,捺
哐	竖,横折,横,横,横,横,竖,横,竖弯
哑	竖,横折,横,横,竖,竖,点,撇,横
哒	竖,横折,横,横,撇,点,点,横折折撇,捺
哓	竖,横折,横,横,斜钩|卧钩,撇,横,撇,竖弯钩
哔	竖,横折,横,横,竖提,撇,竖弯钩,横,竖
哕	竖,横折,横,竖,竖弯,竖,撇,横撇|横钩,点
哗	竖,横折,横,撇,竖,撇,竖弯钩,横,竖
哙	竖,横折,横,撇,捺,横,横,撇折,点
哚	竖,横折,横,撇,横折折|横折弯,横,竖,撇,捺
哝	竖,横折,横,点2,横撇|横钩,撇,竖提,撇,捺
哞	竖,横折,横,撇折,点,撇,横,横,竖
哟	竖,横折,横,撇折,撇折,提,撇,横折钩,点
哢	竖,横折,横,横,横,竖,横,横,撇,竖
哥	横,竖,横折,横,竖,横,竖,横折,横,竖钩
哦	竖,横折,横,撇,横,竖钩,提,斜钩|卧钩,撇,点
哧	竖,横折,横,横,竖,横,撇,竖钩,撇,点
哨	竖,横折,横,竖,点,撇,竖,横折钩,横,横
哩	竖,横折,横,竖,横折,横,横,竖,横,横
哪	竖,横折,横,横折钩,横,横,撇,横折折折钩|横撇弯钩,竖
哭	竖,横折,横,竖,横折,横,横,撇,捺,点
哮	竖,横折,横,横,竖,横,撇,横撇|横钩,竖钩,横
哱	
哲	横,竖钩,提,撇,撇,横,竖,竖,横折,横
哳	竖,横折,横,横,竖钩,提,撇,撇,横,竖
哺	竖,横折,横,横,竖,横折钩,横,横,竖,点
哼	竖,横折,横,点,横,竖,横折,横,横撇|横钩,竖钩
哽	竖,横折,横,横,竖,横折,横,横,撇,捺
哿	横折钩,撇,竖,横折,横,横,竖,横折,横,竖钩
唁	竖,横折,横,点,横,横,横,竖,横折,横
唆	竖,横折,横,撇折,点,撇,点,撇,横撇|横钩,捺
唇	横,撇,横,横,竖提,撇,捺,竖,横折,横
唉	竖,横折,横,撇折,点,撇,横,横,撇,捺
唏	竖,横折,横,撇,点,横,撇,竖,横折钩,竖
唐	点,横,撇,横折,横,横,竖,竖,横折,横
唑	竖,横折,横,撇,点,撇,点,横,竖,横
唔	竖,横折,横,横,竖,横折,横,竖,横折,横
唛	竖,横折,横,横,横,竖,横,撇,横撇|横钩,捺
唝	
唠	竖,横折,横,横,竖,竖,点2,横撇|横钩,横折钩,撇
唢	竖,横折,横,竖,点,撇,竖,横折,撇,点
唣	竖,横折,横,撇,竖,横折,横,横,横,竖弯钩
唤	竖,横折,横,撇,横撇|横钩,竖,横折,横,撇,捺
唧	竖,横折,横,横折,横,横,竖提,点,横折钩,竖
唪	竖,横折,横,横,横,横,撇,捺,横,横,竖
唬	竖,横折,横,竖,横,横撇|横钩,撇,横,竖弯钩,撇,横斜钩
售	撇,竖,点,横,横,横,竖,横,竖,横折,横
唯	竖,横折,横,撇,竖,点,横,横,横,竖,横
唰	竖,横折,横,横折,横,撇,竖,横折钩,竖,竖,竖钩
唱	竖,横折,横,竖,横折,横,横,竖,横折,横,横
唳	竖,横折,横,点,横折,横,撇,横,撇,捺,点
唵	
唷	竖,横折,横,点,横,撇折,点,竖,横折钩,横,横
唼	竖,横折,横,点,横,点,撇,横,撇点,撇,横
唾	竖,横折,横,撇,横,竖,横,竖,竖,横,横
唿	竖,横折,横,撇,横折钩,撇,撇,点2,斜钩|卧钩,点,点
啁	竖,横折,横,撇,横折钩,横,竖,横,竖,横折,横
啃	竖,横折,横,竖,横,竖,横,竖,横折钩,横,横
啄	竖,横折,横,横,撇,弯钩,撇,撇,点,撇,捺
商	点,横,点,撇,竖,横折钩,撇,点,竖,横折,横
啉	竖,横折,横,横,竖,撇,点,横,竖,撇,捺
啊	竖,横折,横,横折折折钩|横撇弯钩,竖,横,竖,横折,横,竖钩
啐	竖,横折,横,点,横,撇,点,撇,点,横,竖
啕	竖,横折,横,撇,横折钩,撇,横,横,竖,竖弯,竖
啖	竖,横折,横,点2,撇,撇,点,点2,撇,撇,捺
啜	竖,横折,横,横撇|横钩,点,横撇|横钩,点,横撇|横钩,点,横撇|横钩,捺
啡	竖,横折,横,竖,横,横,横,竖,横,横,横
啤	竖,横折,横,撇,竖,横折,横,横,撇,横,竖
啥	竖,横折,横,撇,捺,横,横,竖,竖,横折,横
啦	竖,横折,横,横,竖钩,提,点,横,点,撇,横
啧	竖,横折,横,横,横,竖,横,竖,横折,撇,点
啪	竖,横折,横,横,竖钩,提,撇,竖,横折,横,横
啫	
啬	横,竖,点,撇,横,竖,横折,竖,横折,横,横
啭	竖,横折,横,横,撇折,竖,提,横,横,竖折撇|竖折折,点
啮	竖,横折,横,竖,横,竖,横,撇,点,竖弯,竖
啰	竖,横折,横,竖,横折,竖,竖,横,撇,横撇|横钩,点
啴	
啵	竖,横折,横,点,点,提,横撇|横钩,撇,竖,横撇|横钩,捺
啶	竖,横折,横,点,点2,横撇|横钩,横,竖,横,撇,捺
啷	竖,横折,横,点,横折,横,横,竖提,点,横折折折钩|横撇弯钩,竖
啸	竖,横折,横,横折,横,横,竖,撇,竖,撇,点
啻	点,横,点,撇,点2,横撇|横钩,竖,横折钩,竖,竖,横折,横
啼	竖,横折,横,点,横,点,撇,点2,横撇|横钩,竖,横折钩,竖
啾	竖,横折,横,撇,横,竖,撇,点,点2,撇,撇,捺
喀	竖,横折,横,点,点2,横撇|横钩,撇,横撇|横钩,捺,竖,横折,横
喁	竖,横折,横,竖,横折,横,横,竖,横折钩,竖,提,点
喂	竖,横折,横,竖,横折,横,竖,横,横,竖提,撇,捺
喃	竖,横折,横,横,竖,竖,横折钩,点,撇,横,横,竖
善	点,撇,横,横,横,竖,点,撇,横,竖,横折,横
喆	横,竖,横,竖,横折,横,横,竖,横,竖,横折,横
喇	竖,横折,横,横,竖,横折,横,竖,撇,点,竖,竖钩
喈	竖,横折,横,横,竖提,撇,竖弯钩,撇,竖,横折,横,横
喉	竖,横折,横,撇,竖,横折,横,撇,横,横,撇,捺
喊	竖,横折,横,横,撇,横,竖,横折,横,斜钩|卧钩,撇,点
喋	竖,横折,横,横,竖,竖,横,竖弯,横,竖,撇,捺
喏	竖,横折,横,横,竖,竖,横,撇,竖,横折,横
喑	竖,横折,横,点,横,点,撇,横,竖,横折,横,横
喔	竖,横折,横,横折,横,撇,横,撇折,点,横,竖,横
喘	竖,横折,横,竖,竖弯,竖,横,撇,竖,横折钩,竖,竖
喙	竖,横折,横,撇折,横撇|横钩,横,撇,弯钩,撇,撇,撇,捺
喜	横,竖,横,竖,横折,横,点,撇,横,竖,横折,横
喝	竖,横折,横,竖,横折,横,横,撇,横折钩,撇,点,竖弯
喟	竖,横折,横,竖,横折,横,竖,横,竖,横折钩,横,横
喤	
喧	竖,横折,横,点,点2,横撇|横钩,横,竖,横折,横,横,横
喱	竖,横折,横,横,撇,竖,横折,横,横,竖,横,横
喳	竖,横折,横,横,竖,撇,捺,竖,横折,横,横,横
喵	竖,横折,横,横,竖,竖,竖,横折,横,竖,横
喷	竖,横折,横,横,竖,横,竖,竖,竖,横折,撇,点
喹	竖,横折,横,横,撇,捺,横,竖,横,横,竖,横
喻	竖,横折,横,撇,捺,横,竖,横折钩,横,横,竖,竖钩
喽	竖,横折,横,点,撇,横,竖,撇,捺,撇点,撇,横
喾	点,点,撇,点2,横撇|横钩,撇,横,竖,横,竖,横折,横
嗄	竖,横折,横,横,撇,竖,横折,横,横,横,撇,横撇|横钩,捺
嗅	竖,横折,横,撇,竖,横折,横,横,横,横,撇,捺,点
嗉	竖,横折,横,横,横,竖,横,撇折,撇折,点,竖钩,撇,点
嗌	竖,横折,横,点,撇,横,撇,点,竖,横折,竖,竖,横
嗍	竖,横折,横,点,撇,横,竖弯,竖,撇,撇,横折钩,横,横
嗐	
嗑	竖,横折,横,横,竖,横,撇折,点,竖,横折,竖,竖,横
嗒	竖,横折,横,横,竖,竖,撇,捺,横,竖,横折,横
嗓	竖,横折,横,横撇|横钩,点,横撇|横钩,点,横撇|横钩,点,横,竖,撇,捺
嗔	竖,横折,横,横,竖,竖,横折,横,横,横,横,撇,点
嗖	竖,横折,横,撇,竖,横,横折,横,横,竖,横撇|横钩,捺
嗜	竖,横折,横,横,竖,横,撇,撇,竖弯钩,竖,横折,横,横
嗝	竖,横折,横,横,竖,横折,横,竖,横折钩,点,撇,横,竖
嗞	竖,横折,横,点,撇,横,撇折,撇折,点,撇折,撇折,点
嗟	竖,横折,横,点,撇,横,横,横,撇,横,竖,横
嗡	竖,横折,横,撇,捺,撇折,点,横折钩,点,提,横折钩,点,提
嗣	竖,横折,横,竖,横折钩,横,竖,竖,横折钩,横,竖,横折,横
嗤	竖,横折,横,竖弯,竖,竖,横,竖,横折,横,竖,横,点
嗥	竖,横折,横,撇,竖,横折,横,横,横,撇,捺,横,竖
嗦	竖,横折,横,横,竖,点2,横撇|横钩,撇折,撇折,点,竖钩,撇,点
嗨	竖,横折,横,点,点,提,撇,横,竖弯,横折钩,点,横,点
嗪	竖,横折,横,横,横,横,撇,捺,撇,横,竖,撇,点
嗫	竖,横折,横,横,竖,竖,横,横,横,横撇|横钩,点,横撇|横钩,捺
嗬	竖,横折,横,横,竖,竖,撇,竖,横,竖,横折,横,竖钩
嗯	竖,横折,横,竖,横折,横,撇,点,横,点2,斜钩|卧钩,点,点
嗲	竖,横折,横,撇,点,撇,捺,撇,横撇|横钩,点,撇,横撇|横钩,点
嗳	竖,横折,横,撇,点,点,撇,点2,横撇|横钩,横,撇,横撇|横钩,捺
嗵	竖,横折,横,横撇|横钩,点,竖,横折钩,横,横,竖,点,横折折撇,捺
嗷	竖,横折,横,横,横,竖,横,横折钩,撇,撇,横,撇,捺
嗽	竖,横折,横,横,竖,横折,横,竖,撇,点,撇,横撇|横钩,撇,捺
嗾	竖,横折,横,点,横,横折钩,撇,撇,横,撇,横,横,撇,捺
嘀	竖,横折,横,点,横,点,撇,竖,横折钩,横,竖,竖,横折,横
嘁	竖,横折,横,横,撇,竖,横,横,竖钩,撇,点,斜钩|卧钩,撇,点
嘈	竖,横折,横,横,竖,横折,横,竖,竖,横,竖,横折,横,横
嘉	横,竖,横,竖,横折,横,点,撇,横,横折钩,撇,竖,横折,横
嘌	竖,横折,横,横,竖,横折,竖,竖,横,横,横,竖钩,撇,点
嘎	竖,横折,横,横,撇,竖,横折,横,横,横,横,斜钩|卧钩,撇,点
嘏	横,竖,竖,横折,横,横折,横,竖,横,横,横折,横,横撇|横钩,捺
嘘	竖,横折,横,竖,横,横撇|横钩,撇,横,竖弯钩,竖,竖,点,撇,横
嘚	竖,横折,横,撇,撇,竖,竖,横折,横,横,横,横,竖钩,点
嘛	竖,横折,横,点,横,撇,横,竖,撇,点,横,竖,撇,捺
嘞	竖,横折,横,横,竖,竖,横,竖,横折,横,横,竖,横折钩,撇
嘟	竖,横折,横,横,竖,横,撇,竖,横折,横,横,横折折折钩|横撇弯钩,竖
嘡	
嘣	竖,横折,横,竖,竖弯,竖,撇,横折钩,横,横,撇,横折钩,横,横
嘤	竖,横折,横,竖,横折,撇,点,竖,横折,撇,点,撇点,撇,横
嘧	竖,横折,横,点,点2,横撇|横钩,点2,斜钩|卧钩,点,撇,点,竖,竖弯,竖
嘬	竖,横折,横,竖,横折,横,横,横,竖,竖,横,横,提,横撇|横钩,捺
嘭	竖,横折,横,横,竖,横,竖,横折,横,点,撇,提,撇,撇,撇
嘱	竖,横折,横,横折,横,撇,撇,竖,横折,横,竖,横折钩,竖,提,点
嘲	竖,横折,横,横,竖,竖,横折,横,横,横,竖,撇,横折钩,横,横
嘴	竖,横折,横,竖,横,竖,提,撇,竖弯钩,撇,横撇|横钩,撇,横折钩,横,横,竖
嘶	竖,横折,横,横,竖,竖,横,横,横,撇,点,撇,撇,横,竖
嘹	竖,横折,横,横,撇,捺,点,撇,竖,横折,横,横,竖钩,撇,点
嘻	竖,横折,横,横,竖,横,竖,横折,横,点,撇,横,竖,横折,横
嘿	竖,横折,横,竖,横折,点,撇,横,竖,横,横,点2,点,点,点
噀	
噂	
噇	
噌	竖,横折,横,点,撇,竖,横折,竖,点,撇,横,竖,横折,横,横
噍	竖,横折,横,撇,竖,点,横,横,横,竖,横,点2,点,点,点
噎	竖,横折,横,横,竖,横,点2,横撇|横钩,横,竖,横折,横,点,撇,横
噔	竖,横折,横,横撇|横钩,点,撇,撇,捺,横,竖,横折,横,点,撇,横
噗	竖,横折,横,竖,竖,点,撇,横,点,撇,横,横,横,撇,捺
噘	竖,横折,横,横,撇,点,撇,横,竖弯,竖,撇,撇,横撇|横钩,撇,捺
噙	竖,横折,横,撇,捺,点,横,撇,点,竖弯,竖,竖,横折钩,撇折,点
噜	竖,横折,横,撇,横撇|横钩,竖,横折,横,竖,横,横,竖,横折,横,横
噢	竖,横折,横,撇,竖,横折,点,撇,横,竖,撇,点,横,撇,捺
噤	竖,横折,横,横,竖,撇,点,横,竖,撇,捺,横,横,竖钩,撇,点
器	竖,横折,横,竖,横折,横,横,撇,捺,点,竖,横折,横,竖,横折,横
噩	横,竖,竖,横折,横,竖,横折,横,横,竖,横折,横,竖,横折,横,横
噪	竖,横折,横,竖,横折,横,竖,横折,横,竖,横折,横,横,竖,撇,捺
噫	竖,横折,横,点,横,点,撇,横,竖,横折,横,横,点2,斜钩|卧钩,点,点
噬	竖,横折,横,撇,横,点,撇,横,点,横,竖,撇,点,撇,点,横
噱	竖,横折,横,竖,横,横撇|横钩,撇,横,竖弯钩,横,撇,弯钩,撇,撇,撇,捺
噶	竖,横折,横,横,竖,竖,竖,横折,横,横,撇,横折钩,撇,点,竖弯
噻	竖,横折,横,点,点2,横撇|横钩,横,横,竖,竖,横,撇,捺,横,竖,横
噼	竖,横折,横,横折,横,撇,竖,横折,横,点,横,点,撇,横,横,竖
嚄	
嚅	竖,横折,横,横,点2,横撇|横钩,竖,点,点,点,点,横,撇,竖,横折钩,竖,竖
嚆	竖,横折,横,横,竖,竖,点,横,竖,横折,横,竖,横折钩,竖,横折,横
嚎	竖,横折,横,点,横,竖,横折,横,点2,横撇|横钩,横,撇,弯钩,撇,撇,撇,捺
嚏	竖,横折,横,横,竖,点2,横撇|横钩,竖,横折,横,竖,横,横撇|横钩,竖,横,撇,捺
嚓	竖,横折,横,点,点2,横撇|横钩,撇,横撇|横钩,点,点,横撇|横钩,捺,横,横,竖钩,撇,点
嚚	
嚣	竖,横折,横,竖,横折,横,横,撇,竖,横折,撇,点,竖,横折,横,竖,横折,横
嚭	
嚯	竖,横折,横,横,点2,横撇|横钩,竖,点,点,点,点,撇,竖,点,横,横,横,竖,横
嚷	竖,横折,横,点,横,竖,横折,横,竖,横折,横,横,横,竖,竖,横,撇,竖提,撇,捺
嚼	竖,横折,横,撇,点,点,撇,竖,横折,竖,竖,横,横折,横,横,竖提,点,横,竖钩,点
囊	横,竖,横折,横,竖,点2,横撇|横钩,竖,横折,横,竖,横折,横,横,横,竖,竖,横,撇,竖提,撇,捺
囔	竖,横折,横,横,竖,横折,横,竖,点2,横撇|横钩,竖,横折,横,竖,横折,横,横,横,竖,竖,横,撇,竖提,撇,捺
囚	竖,横折,撇,点,横
四	竖,横折,撇,竖弯,横
回	竖,横折,竖,横折,横,横
囟	撇,竖,横折,撇,点,横
因	竖,横折,横,撇,点,横
囡	竖,横折,撇点,撇,横,横
团	竖,横折,横,竖钩,撇,横
囤	竖,横折,横,竖弯,竖,竖弯钩,横
囫	竖,横折,撇,横折钩,撇,撇,横
园	竖,横折,横,横,撇,竖弯钩,横
困	竖,横折,横,竖,撇,点,横
囱	撇,竖,横折,撇,横撇|横钩,点,横
围	竖,横折,横,横,横折钩,竖,横
囵	竖,横折,撇,捺,撇,竖弯钩,横
囷	
囹	竖,横折,撇,捺,点,横撇|横钩,点,横
固	竖,横折,横,竖,竖,横折,横,横
国	竖,横折,横,横,竖,横,点,横
图	竖,横折,撇,横撇|横钩,捺,点,点,横
囿	竖,横折,横,撇,竖,横折钩,横,横,横
圃	竖,横折,横,竖,横折钩,横,横,竖,点,横
圄	竖,横折,横,竖,横折,横,竖,横折,横,横
圆	竖,横折,竖,横折,横,竖,横折,撇,点,横
圈	竖,横折,点,撇,横,横,撇,捺,横折钩,竖弯钩,横
圉	竖,横折,横,竖,横,点,撇,横,横,竖,横
圊	竖,横折,横,横,竖,横,竖,横折钩,横,横,横
圌	
圐	
圙	
圜	竖,横折,竖,横折,竖,竖,横,横,竖,横折,横,撇,竖提,撇,点,横
土	横,竖,横
圢	
圣	横撇|横钩,捺,横,竖,横
在	横,撇,竖,横,竖,横
圩	横,竖,提,横,横,竖钩
圪	横,竖,提,撇,横,横斜钩
圫	
圬	横,竖,提,横,横,竖折折钩
圭	横,竖,横,横,竖,横
圮	横,竖,提,横折,横,竖弯钩
圯	横,竖,提,横折,横,竖弯钩
地	横,竖,提,横折钩,竖,竖弯钩
圲	
圳	横,竖,提,撇,竖,竖
圹	横,竖,提,点,横,撇
场	横,竖,提,横折折折钩|横撇弯钩,撇,撇
圻	横,竖,提,撇,撇,横,竖
圾	横,竖,提,撇,横折折撇,捺
址	横,竖,提,竖,横,竖,横
坂	横,竖,提,撇,撇,横撇|横钩,捺
均	横,竖,提,撇,横折钩,点,提
坉	
坊	横,竖,提,点,横,横折钩,撇
坋	
坌	撇,捺,横折钩,撇,横,竖,横
坍	横,竖,提,撇,横折钩,点,横
坎	横,竖,提,撇,横撇|横钩,撇,捺
坏	横,竖,提,横,撇,竖,点
坐	撇,点,撇,点,横,竖,横
坑	横,竖,提,点,横,撇,横斜钩
坒	
块	横,竖,提,横折,横,撇,捺
坚	竖,竖,横撇|横钩,捺,横,竖,横
坛	横,竖,提,横,横,撇折,点
坜	横,竖,提,横,撇,横折钩,撇
坝	横,竖,提,竖,横折,撇,点
坞	横,竖,提,撇,横折钩,竖折折钩,横
坟	横,竖,提,点,横,撇,捺
坠	横折折折钩|横撇弯钩,竖,撇,捺,横,竖,横
坡	横,竖,提,横撇|横钩,撇,竖,横撇|横钩,捺
坤	横,竖,提,竖,横折,横,横,竖
坥	
坦	横,竖,提,竖,横折,横,横,横
坨	横,竖,提,点,点2,横撇|横钩,撇,竖弯钩
坩	横,竖,提,横,竖,竖,横,横
坪	横,竖,提,横,点,撇,横,竖
坫	横,竖,提,竖,横,竖,横折,横
坬	
坭	横,竖,提,横折,横,撇,撇,竖弯钩
坯	横,竖,提,横,撇,竖,点,横
坰	横,竖,提,竖,横折钩,竖,横折,横
坳	横,竖,提,撇折,撇折,点,横折钩,撇
坷	横,竖,提,横,竖,横折,横,竖钩
坻	横,竖,提,撇,竖提,横,斜钩|卧钩,点
坼	横,竖,提,撇,撇,横,竖,点
坽	
垂	撇,横,竖,横,竖,竖,横,横
垃	横,竖,提,点,横,点,撇,横
垄	横,撇,竖弯钩,撇,点,横,竖,横
垆	横,竖,提,竖,横,横折,横,撇
垈	
型	横,横,撇,竖,竖,竖钩,横,竖,横
垌	横,竖,提,竖,横折钩,横,竖,横折,横
垍	
垎	
垏	
垒	撇折,点,撇折,点,撇折,点,横,竖,横
垓	横,竖,提,点,横,撇折,撇,撇,点
垕	撇,撇,横,竖,横折,横,横,竖,横
垙	
垚	横,竖,横,横,竖,提,横,竖,横
垛	横,竖,提,撇,横折折|横折弯,横,竖,撇,捺
垞	
垟	横,竖,提,点,撇,横,横,横,竖
垠	横,竖,提,横折,横,横,竖提,撇,捺
垡	撇,竖,横,斜钩|卧钩,撇,点,横,竖,横
垢	横,竖,提,撇,撇,横,竖,横折,横
垣	横,竖,提,横,竖,横折,横,横,横
垤	横,竖,提,横,撇折,点,横,竖,横
垦	横折,横,横,竖提,撇,捺,横,竖,横
垧	横,竖,提,撇,竖,横折钩,竖,横折,横
垩	横,竖,竖,点,撇,横,横,竖,横
垫	横,竖钩,提,撇,横斜钩,点,横,竖,横
垭	横,竖,提,横,竖,竖,点,撇,横
垮	横,竖,提,横,撇,捺,横,横,竖折折钩
垯	
垱	
垲	横,竖,提,竖,竖弯,竖,横折,横,竖弯钩
垴	横,竖,提,点,横,撇,点,竖弯,竖
垵	横,竖,提,点,点2,横撇|横钩,撇点,撇,横
垸	横,竖,提,点,点2,横撇|横钩,横,横,撇,竖弯钩
垺	
垾	
垿	
埂	横,竖,提,横,竖,横折,横,横,撇,捺
埃	横,竖,提,撇折,点,撇,横,横,撇,捺
埆	
埇	横,竖,提,横撇|横钩,点,竖,横折钩,横,横,竖
埋	横,竖,提,竖,横折,横,横,竖,横,横
埌	
城	横,竖,提,横,撇,横折钩,斜钩|卧钩,撇,点
埏	横,竖,提,撇,竖,横,竖弯,横折折撇,捺
埒	横,竖,提,撇,点,点,撇,横,竖钩,点
埔	横,竖,提,横,竖,横折钩,横,横,竖,点
埕	横,竖,提,竖,横折,横,横,横,竖,横
埗	横,竖,提,竖,横,竖,横,竖,撇,撇
埘	横,竖,提,竖,横折,横,横,横,竖钩,点
埙	横,竖,提,竖,横折,横,竖,横折,撇,点
埚	横,竖,提,竖,横折,横,竖,横折钩,撇,点
埝	横,竖,提,撇,捺,点,横撇|横钩,点2,斜钩|卧钩,点,点
域	横,竖,提,横,竖,横折,横,提,斜钩|卧钩,撇,点
埠	横,竖,提,撇,竖,横折,横,横折,横,横,竖
埤	横,竖,提,撇,竖,横折,横,横,撇,横,竖
埪	
埫	
埭	横,竖,提,横折,横,横,竖钩,点,提,撇,捺
埯	横,竖,提,横,撇,捺,竖,横折,横,横,竖弯钩
埴	横,竖,提,横,竖,竖,横折,横,横,横,横
埵	
埸	横,竖,提,竖,横折,横,横,撇,横折钩,撇,撇
培	横,竖,提,点,横,点,撇,横,竖,横折,横
基	横,竖,竖,横,横,横,撇,捺,横,竖,横
埼	横,竖,提,横,撇,点,横,竖,横折,横,竖钩
埽	横,竖,提,横折,横,横,点2,横撇|横钩,竖,横折钩,竖
堂	竖,点,撇,点2,横撇|横钩,竖,横折,横,横,竖,横
堃	点,横,横折钩,撇,点,横,横折钩,撇,横,竖,横
堆	横,竖,提,撇,竖,点,横,横,横,竖,横
堇	横,竖,竖,横,竖,横折,横,横,横,竖,横
堉	横,竖,提,点,横,撇折,点,竖,横折钩,横,横
堋	横,竖,提,撇,横折钩,横,横,撇,横折钩,横,横
堌	横,竖,提,竖,横折,横,竖,竖,横折,横,横
堍	横,竖,提,撇,横撇|横钩,竖,横折,横,撇,竖弯钩,点
堎	
堐	
堑	横,撇折,竖,提,撇,撇,横,竖,横,竖,横
堕	横折折折钩|横撇弯钩,竖,横,撇,竖,横折钩,横,横,横,竖,横
堙	横,竖,提,横,竖,横折,竖,竖,横,横,竖,横
堞	横,竖,提,横,竖,竖,横,竖弯,横,竖,撇,捺
堠	横,竖,提,撇,竖,横折,横,撇,横,横,撇,捺
堡	撇,竖,竖,横折,横,横,竖,撇,捺,横,竖,横
堤	横,竖,提,竖,横折,横,横,横,竖,横,撇,捺
堧	
堨	
堪	横,竖,提,横,竖,竖,横,横,横,撇,点,竖弯
堰	横,竖,提,横,竖,横折,横,横,撇点,撇,横,竖弯
堲	
堵	横,竖,提,横,竖,横,撇,竖,横折,横,横
堼	
堽	
堾	
塄	横,竖,提,竖,横折,竖,竖,横,点,横,横折钩,撇
塅	
塆	
塌	横,竖,提,竖,横折,横,横,横折钩,点,提,横折钩,点,提
塍	撇,横折钩,横,横,点,撇,横,横,撇,捺,横,竖,横
塑	点,撇,横,竖弯,竖,撇,撇,横折钩,横,横,横,竖,横
塔	横,竖,提,横,竖,竖,撇,捺,横,竖,横折,横
塘	横,竖,提,点,横,撇,横折,横,横,竖,竖,横折,横
塝	
塞	点,点2,横撇|横钩,横,横,竖,竖,横,撇,捺,横,竖,横
塥	横,竖,提,横,竖,横折,横,竖,横折钩,点,撇,横,竖
填	横,竖,提,横,竖,竖,横折,横,横,横,横,撇,点
塬	横,竖,提,横,撇,撇,竖,横折,横,横,竖钩,撇,点
塱	点,横折,横,横,竖提,点,撇,横折钩,横,横,横,竖,横
塾	点,横,竖,横折,横,横撇|横钩,竖钩,提,撇,横斜钩,点,横,竖,横
墀	横,竖,提,横折,横,撇,竖,点,提,撇,点,撇,横,横,竖
墁	横,竖,提,竖,横折,横,横,竖,横折,竖,竖,横,横撇|横钩,捺
境	横,竖,提,点,横,点,撇,横,竖,横折,横,横,撇,竖弯钩
墅	竖,横折,横,横,竖,横,提,横撇|横钩,点,横撇|横钩,竖钩,横,竖,横
墈	
墉	横,竖,提,点,横,撇,横折,横,横,竖,横折钩,横,横,竖
墐	
墒	横,竖,提,点,横,点,撇,竖,横折钩,撇,点,竖,横折,横
墓	横,竖,竖,竖,横折,横,横,横,撇,捺,横,竖,横
墕	
墘	
墙	横,竖,提,横,竖,点,撇,横,竖,横折,竖,横折,横,横
墚	横,竖,提,点,点,提,横折钩,撇,点2,点,横,竖,撇,捺
增	横,竖,提,点,撇,竖,横折,竖,点,撇,横,竖,横折,横,横
墟	横,竖,提,竖,横,横撇|横钩,撇,横,竖弯钩,竖,竖,点,撇,横
墡	
墣	
墦	
墨	竖,横折,点,撇,横,竖,横,横,点2,点,点,点,横,竖,横
墩	横,竖,提,点,横,竖,横折,横,横撇|横钩,竖钩,提,撇,横,撇,捺
墼	横,竖,横折,横,横,横,竖,竖弯,竖,撇,横折折|横折弯,横撇|横钩,捺,横,竖,横
壁	横折,横,撇,竖,横折,横,点,横,点,撇,横,横,竖,横,竖,横
壅	点,横,撇折,撇折,撇,撇,竖,点,横,横,横,竖,横,横,竖,横
壑	竖,横,点2,横撇|横钩,横,撇,点,撇,捺,竖,横折,横,横撇|横钩,捺,横,竖,横
壕	横,竖,提,点,横,竖,横折,横,点2,横撇|横钩,横,撇,弯钩,撇,撇,撇,捺
壤	横,竖,提,点,横,竖,横折,横,竖,横折,横,横,横,竖,竖,横,撇,竖提,撇,捺
士	横,竖,横
壬	撇,横,竖,横
壮	点,提,竖,横,竖,横
声	横,竖,横,横折,竖,横,撇
壳	横,竖,横,点2,横撇|横钩,撇,横斜钩
壶	横,竖,横,点2,横撇|横钩,竖,竖,点,撇,横
壸	
壹	横,竖,横,点2,横撇|横钩,横,竖,横折,横,点,撇,横
处	撇,横撇|横钩,捺,竖,点
备	撇,横撇|横钩,捺,竖,横折,横,竖,横
复	撇,横,竖,横折,横,横,撇,横撇|横钩,捺
夏	横,撇,竖,横折,横,横,横,撇,横撇|横钩,捺
夐	
夔	点,撇,横,撇,竖,横折,横,横,横,竖,横,竖,提,横折,横,竖弯钩,撇,点,撇,横撇|横钩,捺
夕	撇,横撇|横钩,点
外	撇,横撇|横钩,点,竖,点
夙	撇,横斜钩,横,撇,横撇|横钩,点
多	撇,横撇|横钩,点,撇,横撇|横钩,点
夜	点,横,撇,竖,撇,横撇|横钩,点,捺
够	撇,横折钩,竖,横折,横,撇,横撇|横钩,点,撇,横撇|横钩,点
夤	撇,横撇|横钩,点,点,点2,横撇|横钩,横,竖,横折,横,竖,横,撇,点
夥	竖,横折,横,横,横,竖,撇,点,撇,横撇|横钩,点,撇,横撇|横钩,点
大	横,撇,捺
天	横,横,撇,捺
太	横,撇,捺,点
夫	横,横,撇,捺
夬	
夭	撇,横,撇,捺
央	竖,横折,横,撇,捺
夯	横,撇,捺,横折钩,撇
失	撇,横,横,撇,捺
头	点,点,横,撇,点
夷	横,横折,横,竖折折钩,撇,捺
夸	横,撇,捺,横,横,竖折折钩
夹	横,点,撇,横,撇,捺
夺	横,撇,捺,横,竖钩,点
夼	横,撇,捺,撇,竖,竖
奁	横,撇,捺,横,撇,点,竖弯
奂	撇,横撇|横钩,竖,横折,横,撇,捺
奄	横,撇,捺,竖,横折,横,横,竖弯钩
奇	横,撇,点,横,竖,横折,横,竖钩
奈	横,撇,捺,横,横,竖钩,撇,点
奉	横,横,横,撇,捺,横,横,竖
奋	横,撇,捺,竖,横折,横,竖,横
奎	横,撇,捺,横,竖,横,横,竖,横
奏	横,横,横,撇,捺,横,横,撇,点
契	横,横,横,竖,横折钩,撇,横,撇,捺
奓	
奔	横,撇,捺,横,竖,横,撇,竖
奕	点,横,撇,竖钩,撇,点,横,撇,捺
奖	点,提,竖,撇,横撇|横钩,点,横,撇,捺
套	横,撇,捺,横,竖,横,横,横,撇折,点
奘	竖弯,竖,横,撇,横,竖,横,横,撇,捺
奚	撇,点,点,撇,撇折,撇折,点,横,撇,捺
奠	点,撇,横,竖,横折,撇,竖弯,横,横,横,撇,捺
奡	
奢	横,撇,捺,横,竖,横,撇,竖,横折,横,横
奥	撇,竖,横折,点,撇,横,竖,撇,点,横,撇,捺
奭	横,横,撇,竖,横折,横,横,横,撇,竖,横折,横,横,撇,捺
女	撇点,撇,横
奴	撇点,撇,横,横撇|横钩,捺
奶	撇点,撇,横,横折折折钩|横撇弯钩,撇
奸	撇点,撇,横,横,横,竖
她	撇点,撇,横,横折钩,竖,竖弯钩
好	撇点,撇,横,横撇|横钩,竖钩,横
妁	撇点,撇,横,撇,横折钩,点
如	撇点,撇,横,竖,横折,横
妃	撇点,撇,横,横折,横,竖弯钩
妄	点,横,竖弯,撇点,撇,横
妆	点,提,竖,撇点,撇,横
妇	撇点,撇,横,横折,横,横
妈	撇点,撇,横,横折,竖折折钩,横
妊	撇点,撇,横,撇,横,竖,横
妍	撇点,撇,横,横,横,撇,竖
妒	撇点,撇,横,点,横折,横,撇
妓	撇点,撇,横,横,竖,横撇|横钩,捺
妖	撇点,撇,横,撇,横,撇,捺
妗	撇点,撇,横,撇,捺,点,横撇|横钩
妘	
妙	撇点,撇,横,竖,撇,点,撇
妞	撇点,撇,横,横折,竖,横,横
妣	撇点,撇,横,横,竖提,撇,竖弯钩
妤	撇点,撇,横,横撇|横钩,点,横撇|横钩,竖钩
妥	撇,点,点,撇,撇点,撇,横
妧	
妨	撇点,撇,横,点,横,横折钩,撇
妩	撇点,撇,横,横,横,撇,竖弯钩
妪	撇点,撇,横,横,撇,点,竖弯
妫	撇点,撇,横,点,撇,横折钩,点
妭	
妮	撇点,撇,横,横折,横,撇,撇,竖弯钩
妯	撇点,撇,横,竖,横折,横,竖,横
妲	撇点,撇,横,竖,横折,横,横,横
妹	撇点,撇,横,横,横,竖,撇,捺
妻	横,横折,横,横,竖,撇点,撇,横
妾	点,横,点,撇,横,撇点,撇,横
姆	撇点,撇,横,竖弯,横折钩,点,横,点
姈	撇点,撇,横,撇,捺,点,横撇|横钩,点
姊	撇点,撇,横,撇,竖折折钩,竖,撇
始	撇点,撇,横,撇折,点,竖,横折,横
姐	撇点,撇,横,竖,横折,横,横,横
姑	撇点,撇,横,横,竖,竖,横折,横
姒	撇点,撇,横,竖提,点,撇,点
姓	撇点,撇,横,撇,横,横,竖,横
委	撇,横,竖,撇,捺,撇点,撇,横
姗	撇点,撇,横,撇,横折钩,撇,横折钩,横
姘	撇点,撇,横,点,撇,横,横,撇,竖
姚	撇点,撇,横,撇,点,提,竖弯钩,撇,点
姜	点,撇,横,横,竖,横,撇点,撇,横
姝	撇点,撇,横,撇,横,横,竖,撇,捺
姞	
姣	撇点,撇,横,点,横,撇,点,撇,捺
姤	
姥	撇点,撇,横,横,竖,横,撇,撇,竖弯钩
姨	撇点,撇,横,横,横折,横,竖折折钩,撇,捺
姬	撇点,撇,横,横,竖,竖,横折,横,竖,竖弯
姮	撇点,撇,横,横,竖,横折,横,横,横
姱	
姶	
姹	撇点,撇,横,点,点2,横撇|横钩,撇,横,竖弯钩
姻	撇点,撇,横,竖,横折,横,撇,点,横
姽	
姿	点,提,撇,横撇|横钩,撇,捺,撇点,撇,横
娀	
威	横,撇,横,撇点,撇,横,斜钩|卧钩,撇,点
娃	撇点,撇,横,横,竖,横,横,竖,横
娄	点,撇,横,竖,撇,捺,撇点,撇,横
娅	撇点,撇,横,横,竖,竖,点,撇,横
娆	撇点,撇,横,横,斜钩|卧钩,撇,横,撇,竖弯钩
娇	撇点,撇,横,撇,横,撇,捺,撇,竖
娈	点,横,竖,竖,撇,点,撇点,撇,横
娉	撇点,撇,横,竖,横折,横,竖,横,横,竖折折钩
娌	撇点,撇,横,竖,横折,横,横,竖,横,横
娑	点,点,提,竖,撇,点,撇,撇点,撇,横
娓	撇点,撇,横,横折,横,撇,撇,横,横,竖弯钩
娘	撇点,撇,横,点,横折,横,横,竖提,撇,捺
娜	撇点,撇,横,横折钩,横,横,撇,横折折折钩|横撇弯钩,竖
娟	撇点,撇,横,竖,横折,横,竖,横折钩,横,横
娠	撇点,撇,横,横,撇,横,横,竖提,撇,捺
娣	撇点,撇,横,点,撇,横折,横,竖折折钩,竖,撇
娥	撇点,撇,横,撇,横,竖钩,提,斜钩|卧钩,撇,点
娩	撇点,撇,横,撇,横撇|横钩,竖,横折,横,撇,竖弯钩
娱	撇点,撇,横,竖,横折,横,横,横,撇,捺
娲	撇点,撇,横,竖,横折,横,竖,横折钩,撇,点
娴	撇点,撇,横,点,竖,横折钩,横,竖,撇,点
娵	
娶	横,竖,竖,横,横,提,横撇|横钩,捺,撇点,撇,横
娼	撇点,撇,横,竖,横折,横,横,竖,横折,横,横
婀	撇点,撇,横,横折折折钩|横撇弯钩,竖,横,竖,横折,横,竖钩
婆	点,点,提,横撇|横钩,撇,竖,横撇|横钩,捺,撇点,撇,横
婉	撇点,撇,横,点,点2,横撇|横钩,撇,横撇|横钩,点,横折钩,竖弯钩
婊	撇点,撇,横,横,横,竖,横,撇,竖提,撇,捺
婌	
婍	
婕	撇点,撇,横,横,横折,横,横,竖,横,撇,捺
婘	
婚	撇点,撇,横,撇,竖提,横,斜钩|卧钩,竖,横折,横,横
婞	
婠	
婢	撇点,撇,横,撇,竖,横折,横,横,撇,横,竖
婤	
婧	撇点,撇,横,横,横,竖,横,竖,横折钩,横,横
婪	横,竖,撇,点,横,竖,撇,捺,撇点,撇,横
婫	
婳	
婴	竖,横折,撇,点,竖,横折,撇,点,撇点,撇,横
婵	撇点,撇,横,点,撇,竖,横折,横,横,横,竖
婶	撇点,撇,横,点,点2,横撇|横钩,竖,横折,横,横,竖
婷	撇点,撇,横,点,横,竖,横折,横,点2,横撇|横钩,横,竖钩
婺	横撇|横钩,点,横撇|横钩,竖钩,撇,撇,横,撇,捺,撇点,撇,横
婻	
婼	
婿	撇点,撇,横,横撇|横钩,竖,横,撇,捺,竖,横折钩,横,横
媂	
媄	
媆	
媒	撇点,撇,横,横,竖,竖,横,横,横,竖,撇,捺
媓	
媖	
媚	撇点,撇,横,横折,竖,横,撇,竖,横折,横,横,横
媛	撇点,撇,横,撇,点,点,撇,横,横,撇,横撇|横钩,捺
媞	
媪	撇点,撇,横,竖,横折,横,横,竖,横折,竖,竖,横
媭	
媱	
媲	撇点,撇,横,撇,竖,横折,撇,点,横,横,竖提,撇,竖弯钩
媳	撇点,撇,横,撇,竖,横折,横,横,横,点2,斜钩|卧钩,点,点
媵	撇,横折钩,横,横,点,撇,横,横,撇,捺,撇点,撇,横
媸	撇点,撇,横,竖弯,竖,竖,横,竖,横折,横,竖,横,点
媾	撇点,撇,横,横,横,竖,竖,横,竖,横折钩,横,竖,横
嫁	撇点,撇,横,点,点2,横撇|横钩,横,撇,弯钩,撇,撇,撇,捺
嫂	撇点,撇,横,撇,竖,横,横折,横,横,竖,横撇|横钩,捺
嫄	
嫉	撇点,撇,横,点,横,撇,点,提,撇,横,横,撇,捺
嫌	撇点,撇,横,点,撇,横,横折,横,横,竖,竖,撇,捺
嫒	撇点,撇,横,撇,点,点,撇,点2,横撇|横钩,横,撇,横撇|横钩,捺
嫔	撇点,撇,横,点,点2,横撇|横钩,撇,竖,横,竖,横,撇,点
嫕	
嫖	撇点,撇,横,横,竖,横折,竖,竖,横,横,横,竖钩,撇,点
嫘	撇点,撇,横,竖,横折,横,竖,横,撇折,撇折,点,竖钩,撇,点
嫚	撇点,撇,横,竖,横折,横,横,竖,横折,竖,竖,横,横撇|横钩,捺
嫜	撇点,撇,横,点,横,点,撇,横,竖,横折,横,横,横,竖
嫠	横,横,竖,撇,点,撇,横,撇,捺,横,撇,撇点,撇,横
嫡	撇点,撇,横,点,横,点,撇,竖,横折钩,横,竖,竖,横折,横
嫣	撇点,撇,横,横,竖,横,竖,横,横,竖折折钩,点2,点,点,点
嫦	撇点,撇,横,竖,点,撇,点2,横撇|横钩,竖,横折,横,竖,横折钩,竖
嫩	撇点,撇,横,横,竖,横折,横,竖,撇,点,撇,横,撇,捺
嫪	
嫫	撇点,撇,横,横,竖,竖,竖,横折,横,横,横,撇,捺
嫭	
嫱	撇点,撇,横,横,竖,点,撇,横,竖,横折,竖,横折,横,横
嫽	
嬉	撇点,撇,横,横,竖,横,竖,横折,横,点,撇,横,竖,横折,横
嬖	横折,横,撇,竖,横折,横,点,横,点,撇,横,横,竖,撇点,撇,横
嬗	撇点,撇,横,点,横,竖,横折,竖,横折,横,横,竖,横折,横,横,横
嬛	撇点,撇,横,竖,横折,竖,竖,横,横,竖,横折,横,撇,竖提,撇,捺
嬥	
嬬	
嬴	点,横,竖弯,竖,横折,横,撇,横折钩,横,横,撇点,撇,横,撇,横斜钩,点
嬷	撇点,撇,横,点,横,撇,横,竖,撇,点,横,竖,撇,捺,撇,撇折,点
嬿	
孀	撇点,撇,横,横,点2,横撇|横钩,竖,点,点,点,点,横,竖,撇,点,竖,横折,横,横,横
孅	
子	横撇|横钩,竖钩,横
孑	横撇|横钩,竖钩,提
孓	横撇|横钩,竖钩,捺
孔	横撇|横钩,竖钩,提,竖弯钩
孕	横折折折钩|横撇弯钩,撇,横撇|横钩,竖钩,横
孖	横撇|横钩,竖钩,提,横撇|横钩,竖钩,横
字	点,点2,横撇|横钩,横撇|横钩,竖钩,横
存	横,撇,竖,横撇|横钩,竖钩,横
孙	横撇|横钩,竖钩,提,竖钩,撇,点
孚	撇,点,点,撇,横撇|横钩,竖钩,横
孛	横,竖,点2,横撇|横钩,横撇|横钩,竖钩,横
孜	横撇|横钩,竖钩,提,撇,横,撇,捺
孝	横,竖,横,撇,横撇|横钩,竖钩,横
孟	横撇|横钩,竖钩,横,竖,横折,竖,竖,横
孢	横撇|横钩,竖钩,提,撇,横折钩,横折,横,竖弯钩
季	撇,横,竖,撇,捺,横撇|横钩,竖钩,横
孤	横撇|横钩,竖钩,提,撇,撇,竖提,点,捺
孥	撇点,撇,横,横撇|横钩,捺,横撇|横钩,竖钩,横
学	点,点,撇,点2,横撇|横钩,横撇|横钩,竖钩,横
孩	横撇|横钩,竖钩,提,点,横,撇折,撇,撇,点
孪	点,横,竖,竖,撇,点,横撇|横钩,竖钩,横
孬	横,撇,竖,点,撇点,撇,横,横撇|横钩,竖钩,横
孰	点,横,竖,横折,横,横撇|横钩,竖钩,提,撇,横斜钩,点
孱	横折,横,撇,横撇|横钩,竖钩,横,横撇|横钩,竖钩,提,横撇|横钩,竖钩,横
孳	点,撇,横,撇折,撇折,点,撇折,撇折,点,横撇|横钩,竖钩,横
孵	撇,竖提,点,撇,横折钩,竖,点,撇,点,点,撇,横撇|横钩,竖钩,横
孺	横撇|横钩,竖钩,提,横,点2,横撇|横钩,竖,点,点,点,点,横,撇,竖,横折钩,竖,竖
孽	横,竖,竖,撇,竖,横折,横,横折,横,点,横,点,撇,横,横,竖,横撇|横钩,竖钩,横
宁	点,点2,横撇|横钩,横,竖钩
它	点,点2,横撇|横钩,撇,竖弯钩
宄	点,点2,横撇|横钩,撇,横斜钩
宅	点,点2,横撇|横钩,撇,横,竖弯钩
宇	点,点2,横撇|横钩,横,横,竖钩
守	点,点2,横撇|横钩,横,竖钩,点
安	点,点2,横撇|横钩,撇点,撇,横
宋	点,点2,横撇|横钩,横,竖,撇,捺
完	点,点2,横撇|横钩,横,横,撇,竖弯钩
宏	点,点2,横撇|横钩,横,撇,撇折,点
宓	点,点2,横撇|横钩,点2,斜钩|卧钩,点,撇,点
宕	点,点2,横撇|横钩,横,撇,竖,横折,横
宗	点,点2,横撇|横钩,横,横,竖钩,撇,点
官	点,点2,横撇|横钩,竖,横折,横,横折,横
宙	点,点2,横撇|横钩,竖,横折,横,竖,横
定	点,点2,横撇|横钩,横,竖,横,撇,捺
宛	点,点2,横撇|横钩,撇,横撇|横钩,点,横折钩,竖弯钩
宜	点,点2,横撇|横钩,竖,横折,横,横,横
宝	点,点2,横撇|横钩,横,横,竖,横,点
实	点,点2,横撇|横钩,点,点,横,撇,点
宠	点,点2,横撇|横钩,横,撇,竖弯钩,撇,点
审	点,点2,横撇|横钩,竖,横折,横,横,竖
客	点,点2,横撇|横钩,撇,横撇|横钩,捺,竖,横折,横
宣	点,点2,横撇|横钩,横,竖,横折,横,横,横
室	点,点2,横撇|横钩,横,撇折,点,横,竖,横
宥	点,点2,横撇|横钩,横,撇,竖,横折钩,横,横
宦	点,点2,横撇|横钩,横,竖,横折,横,竖,竖弯
宧	
宪	点,点2,横撇|横钩,撇,横,竖,横,撇,竖弯钩
宫	点,点2,横撇|横钩,竖,横折,横,竖,横折,横
宬	
宰	点,点2,横撇|横钩,点,横,点,撇,横,横,竖
害	点,点2,横撇|横钩,横,横,横,竖,竖,横折,横
宴	点,点2,横撇|横钩,竖,横折,横,横,撇点,撇,横
宵	点,点2,横撇|横钩,竖,点,撇,竖,横折钩,横,横
家	点,点2,横撇|横钩,横,撇,弯钩,撇,撇,撇,捺
宸	点,点2,横撇|横钩,横,撇,横,横,竖提,撇,捺
容	点,点2,横撇|横钩,撇,点,撇,捺,竖,横折,横
宽	点,点2,横撇|横钩,横,竖,竖,竖,横折,撇,竖弯钩
宾	点,点2,横撇|横钩,撇,竖,横,竖,横,撇,点
宿	点,点2,横撇|横钩,撇,竖,横,撇,竖,横折,横,横
寁	
寂	点,点2,横撇|横钩,竖,横,横,竖钩,撇,点,横撇|横钩,捺
寄	点,点2,横撇|横钩,横,撇,点,横,竖,横折,横,竖钩
寅	点,点2,横撇|横钩,横,竖,横折,横,竖,横,撇,点
密	点,点2,横撇|横钩,点2,斜钩|卧钩,点,撇,点,竖,竖弯,竖
寇	点,点2,横撇|横钩,横,横,撇,竖弯钩,竖,横,横撇|横钩,点
富	点,点2,横撇|横钩,横,竖,横折,横,竖,横折,横,竖,横
寐	点,点2,横撇|横钩,竖弯,竖,横,撇,横,横,竖,撇,捺
寒	点,点2,横撇|横钩,横,横,竖,竖,横,撇,捺,点,点
寓	点,点2,横撇|横钩,竖,横折,横,横,竖,横折钩,竖,提,点
寝	点,点2,横撇|横钩,点,提,竖,横折,横,横,点2,横撇|横钩,横撇|横钩,捺
寞	点,点2,横撇|横钩,横,竖,竖,竖,横折,横,横,横,撇,捺
察	点,点2,横撇|横钩,撇,横撇|横钩,点,点,横撇|横钩,捺,横,横,竖钩,撇,点
寡	点,点2,横撇|横钩,横,撇,竖,横折,横,横,横,撇,捺,横折钩,撇
寤	点,点2,横撇|横钩,竖弯,竖,横,撇,横,竖,横折,横,竖,横折,横
寥	点,点2,横撇|横钩,横折,点,提,横折,点,提,撇,捺,撇,撇,撇
寨	点,点2,横撇|横钩,横,横,竖,竖,横,撇,捺,横,竖钩,撇,点
寮	点,点2,横撇|横钩,横,撇,捺,点,撇,竖,横折,横,横,竖钩,撇,点
寰	点,点2,横撇|横钩,竖,横折,竖,竖,横,横,竖,横折,横,撇,竖提,撇,捺
寸	横,竖钩,点
对	横撇|横钩,点,横,竖钩,点
寺	横,竖,横,横,竖钩,点
寻	横折,横,横,横,竖钩,点
导	横折,横,竖弯钩,横,竖钩,点
寿	横,横,横,撇,横,竖钩,点
封	横,竖,横,横,竖,提,横,竖钩,点
射	撇,竖,横折钩,横,横,横,撇,横,竖钩,点
将	点,提,竖,撇,横撇|横钩,点,横,竖钩,点
尉	横折,横,撇,横,横,竖钩,撇,点,横,竖钩,点
尊	点,撇,横,竖,横折,撇,竖弯,横,横,横,竖钩,点
小	竖钩,撇,点
少	竖,撇,点,撇
尔	撇,横撇|横钩,竖钩,撇,点
尕	横折折折钩|横撇弯钩,撇,竖钩,撇,点
尖	竖,撇,点,横,撇,捺
尘	竖,撇,点,横,竖,横
尚	竖,点,撇,竖,横折钩,竖,横折,横
尜	竖,撇,点,横,撇,捺,竖钩,撇,点
尝	竖,点,撇,点2,横撇|横钩,横,横,撇折,点
尢	横,撇,竖弯钩
尤	横,撇,竖弯钩,点
尥	横,撇,竖弯钩,撇,横折钩,点
尧	横,斜钩|卧钩,撇,横,撇,竖弯钩
尨	
尪	
尬	横,撇,竖弯钩,撇,捺,撇,竖
就	点,横,竖,横折,横,竖钩,撇,点,横,撇,竖弯钩,点
尴	横,撇,竖弯钩,竖,竖,撇,横,点,竖,横折,竖,竖,横
尸	横折,横,撇
尹	横折,横,横,撇
尺	横折,横,撇,捺
尻	横折,横,撇,撇,横斜钩
尼	横折,横,撇,撇,竖弯钩
尽	横折,横,撇,捺,点,点
尾	横折,横,撇,撇,横,横,竖弯钩
尿	横折,横,撇,竖钩,横撇|横钩,撇,捺
局	横折,横,撇,横折钩,竖,横折,横
屁	横折,横,撇,横,竖提,撇,竖弯钩
层	横折,横,撇,横,横,撇折,点
屃	
居	横折,横,撇,横,竖,竖,横折,横
屈	横折,横,撇,竖弯,竖,竖,竖弯,竖
屉	横折,横,撇,横,竖,竖,横,竖弯
届	横折,横,撇,竖,横折,横,竖,横
屋	横折,横,撇,横,撇折,点,横,竖,横
屎	横折,横,撇,点,撇,横,竖,撇,捺
屏	横折,横,撇,点,撇,横,横,撇,竖
屐	横折,横,撇,撇,撇,竖,横,竖,横撇|横钩,捺
屑	横折,横,撇,竖,点,撇,竖,横折钩,横,横
展	横折,横,撇,横,竖,竖,横,竖提,撇,捺
屙	横折,横,撇,横折折折钩|横撇弯钩,竖,横,竖,横折,横,竖钩
属	横折,横,撇,撇,竖,横折,横,竖,横折钩,竖,提,点
屠	横折,横,撇,横,竖,横,撇,竖,横折,横,横
屡	横折,横,撇,点,撇,横,竖,撇,捺,撇点,撇,横
屣	横折,横,撇,撇,撇,竖,竖,横,竖,横,竖,横,撇,捺
履	横折,横,撇,撇,撇,竖,撇,横,竖,横折,横,横,撇,横撇|横钩,捺
屦	横折,横,撇,撇,撇,竖,点,撇,横,竖,撇,捺,撇点,撇,横
屯	横,竖弯,竖,竖弯钩
山	竖,竖弯,竖
屹	竖,竖弯,竖,撇,横,横斜钩
屺	竖,竖弯,竖,横折,横,竖弯钩
屼	
屾	竖,竖弯,竖,竖,竖弯,竖
屿	竖,竖弯,竖,横,竖折折钩,横
岁	竖,竖弯,竖,撇,横撇|横钩,点
岂	竖,竖弯,竖,横折,横,竖弯钩
岈	竖,竖弯,竖,横,撇折,竖钩,撇
岊	
岌	竖,竖弯,竖,撇,横折折撇,捺
岍	竖,竖弯,竖,横,横,撇,竖
岐	竖,竖弯,竖,横,竖,横撇|横钩,捺
岑	竖,竖弯,竖,撇,捺,点,横撇|横钩
岔	撇,捺,横折钩,撇,竖,竖弯,竖
岖	竖,竖弯,竖,横,撇,点,竖弯
岗	竖,竖弯,竖,竖,横折钩,撇,点
岘	竖,竖弯,竖,竖,横折,撇,竖弯钩
岙	撇,横,撇,捺,竖,竖弯,竖
岚	竖,竖弯,竖,撇,横斜钩,撇,点
岛	撇,横折钩,点,竖折折钩,竖,竖弯,竖
岜	竖,竖弯,竖,横折,竖,横,竖弯钩
岞	
岠	
岢	竖,竖弯,竖,横,竖,横折,横,竖钩
岣	竖,竖弯,竖,撇,横折钩,竖,横折,横
岨	
岩	竖,竖弯,竖,横,撇,竖,横折,横
岫	竖,竖弯,竖,竖,横折,横,竖,横
岬	竖,竖弯,竖,竖,横折,横,横,竖
岭	竖,竖弯,竖,撇,捺,点,横撇|横钩,点
岱	撇,竖,横,斜钩|卧钩,点,竖,竖弯,竖
岳	撇,竖,横,竖,横,竖,竖弯,竖
岵	竖,竖弯,竖,横,竖,竖,横折,横
岷	竖,竖弯,竖,横折,横,竖提,横,斜钩|卧钩
岸	竖,竖弯,竖,横,撇,横,横,竖
岽	竖,竖弯,竖,横,撇折,竖钩,撇,点
岿	竖,竖弯,竖,竖,撇,横折,横,横
峁	竖,竖弯,竖,撇,竖提,撇,横折钩,竖
峂	
峃	
峄	竖,竖弯,竖,横撇|横钩,捺,横,横,竖
峋	竖,竖弯,竖,撇,横折钩,竖,横折,横,横
峒	竖,竖弯,竖,竖,横折钩,横,竖,横折,横
峗	
峘	
峙	竖,竖弯,竖,横,竖,横,横,竖钩,点
峛	
峡	竖,竖弯,竖,横,点,撇,横,撇,捺
峣	
峤	竖,竖弯,竖,撇,横,撇,捺,撇,竖
峥	竖,竖弯,竖,撇,横撇|横钩,横折,横,横,竖钩
峦	点,横,竖,竖,撇,点,竖,竖弯,竖
峧	
峨	竖,竖弯,竖,撇,横,竖钩,提,斜钩|卧钩,撇,点
峪	竖,竖弯,竖,撇,点,撇,捺,竖,横折,横
峭	竖,竖弯,竖,竖,点,撇,竖,横折钩,横,横
峰	竖,竖弯,竖,撇,横撇|横钩,捺,横,横,横,竖
峱	
峻	竖,竖弯,竖,撇折,点,撇,点,撇,横撇|横钩,捺
峿	
崀	竖,竖弯,竖,点,横折,横,横,竖提,撇,捺
崁	
崂	竖,竖弯,竖,横,竖,竖,点2,横撇|横钩,横折钩,撇
崃	竖,竖弯,竖,横,点,撇,横,竖,撇,捺
崄	
崆	竖,竖弯,竖,点,点2,横撇|横钩,撇,点,横,竖,横
崇	竖,竖弯,竖,点,点2,横撇|横钩,横,横,竖钩,撇,点
崌	
崎	竖,竖弯,竖,横,撇,点,横,竖,横折,横,竖钩
崒	
崔	竖,竖弯,竖,撇,竖,点,横,横,横,竖,横
崖	竖,竖弯,竖,横,撇,横,竖,横,横,竖,横
崚	
崛	竖,竖弯,竖,横折,横,撇,竖弯,竖,竖,竖弯,竖
崞	竖,竖弯,竖,点,横,竖,横折,横,横撇|横钩,竖钩,横
崟	
崡	
崤	竖,竖弯,竖,撇,点,横,撇,竖,横折钩,横,横
崦	竖,竖弯,竖,横,撇,捺,竖,横折,横,横,竖弯钩
崧	竖,竖弯,竖,横,竖,撇,点,撇,捺,撇折,点
崩	竖,竖弯,竖,撇,横折钩,横,横,撇,横折钩,横,横
崭	竖,竖弯,竖,横,撇折,竖,提,撇,撇,横,竖
崮	竖,竖弯,竖,竖,横折,横,竖,竖,横折,横,横
崴	竖,竖弯,竖,横,撇,横,撇点,撇,横,斜钩|卧钩,撇,点
崶	
崽	竖,竖弯,竖,竖,横折,横,竖,横,点2,斜钩|卧钩,点,点
崾	竖,竖弯,竖,横,竖,横折,竖,竖,横,撇点,撇,横
崿	
嵁	
嵅	
嵇	撇,横,竖,撇,点,横,撇,竖弯钩,点,竖,竖弯,竖
嵊	竖,竖弯,竖,撇,横,竖,竖,横,提,撇,竖弯钩,撇,捺
嵋	竖,竖弯,竖,横折,竖,横,撇,竖,横折,横,横,横
嵌	竖,竖弯,竖,横,竖,竖,横,横,撇,横撇|横钩,撇,捺
嵎	
嵖	
嵘	竖,竖弯,竖,横,竖,竖,点2,横撇|横钩,横,竖,撇,捺
嵚	
嵛	竖,竖弯,竖,撇,捺,横,竖,横折钩,横,横,竖,竖钩
嵝	竖,竖弯,竖,点,撇,横,竖,撇,捺,撇点,撇,横
嵩	竖,竖弯,竖,点,横,竖,横折,横,竖,横折钩,竖,横折,横
嵫	竖,竖弯,竖,点,撇,横,撇折,撇折,点,撇折,撇折,点
嵬	竖,竖弯,竖,撇,竖,横折,横,横,撇,竖弯钩,撇折,点
嵯	竖,竖弯,竖,点,撇,横,横,横,撇,横,竖,横
嵲	
嵴	竖,竖弯,竖,点,提,撇,点,撇,捺,竖,横折钩,横,横
嶂	竖,竖弯,竖,点,横,点,撇,横,竖,横折,横,横,横,竖
嶅	
嶍	
嶒	
嶓	
嶙	竖,竖弯,竖,点,撇,横,竖,撇,捺,撇,横撇|横钩,点,横,撇折,竖
嶝	竖,竖弯,竖,横撇|横钩,点,撇,撇,捺,横,竖,横折,横,点,撇,横
嶟	
嶦	
嶲	
嶷	竖,竖弯,竖,撇,竖弯钩,撇,横,横,撇,点,横撇|横钩,点,横撇|横钩,竖,横,撇,捺
巅	竖,竖弯,竖,横,竖,竖,横折,横,横,横,横,撇,点,横,撇,竖,横折,撇,点
巇	
巉	
巍	竖,竖弯,竖,撇,横,竖,撇,点,撇点,撇,横,撇,竖,横折,横,横,撇,竖弯钩,撇折,点
川	撇,竖,竖
州	点2,撇,点,竖,点,竖
巡	撇点,撇点,撇点,点,横折折撇,捺
巢	撇点,撇点,撇点,竖,横折,横,横,横,竖,撇,捺
工	横,竖,横
左	横,撇,横,竖,横
巧	横,竖,提,横,竖折折钩
巨	横,横折,横,竖弯
巩	横,竖,提,撇,横斜钩,点
巫	横,竖,撇,点,撇,点,横
差	点,撇,横,横,横,撇,横,竖,横
巯	横撇|横钩,点,横,竖,提,点,横,撇折,点,撇,竖,竖弯钩
己	横折,横,竖弯钩
已	横折,横,竖弯钩
巳	横折,横,竖弯钩
巴	横折,竖,横,竖弯钩
巷	横,竖,竖,横,撇,捺,横折,横,竖弯钩
巽	横折,横,竖弯钩,横折,横,竖弯钩,横,竖,竖,横,撇,点
巾	竖,横折钩,竖
币	撇,竖,横折钩,竖
市	点,横,竖,横折钩,竖
布	横,撇,竖,横折钩,竖
帅	竖,撇,竖,横折钩,竖
帆	竖,横折钩,竖,撇,横斜钩,点
师	竖,撇,横,竖,横折钩,竖
希	撇,点,横,撇,竖,横折钩,竖
帏	竖,横折钩,竖,横,横,横折钩,竖
帐	竖,横折钩,竖,撇,横,竖提,捺
帑	撇点,撇,横,横撇|横钩,捺,竖,横折钩,竖
帔	竖,横折钩,竖,横撇|横钩,撇,竖,横撇|横钩,捺
帕	竖,横折钩,竖,撇,竖,横折,横,横
帖	竖,横折钩,竖,竖,横,竖,横折,横
帘	点,点2,横撇|横钩,撇,点,竖,横折钩,竖
帙	竖,横折钩,竖,撇,横,横,撇,捺
帚	横折,横,横,点2,横撇|横钩,竖,横折钩,竖
帛	撇,竖,横折,横,横,竖,横折钩,竖
帜	竖,横折钩,竖,竖,横折,横,撇,点
帝	点,横,点,撇,点2,横撇|横钩,竖,横折钩,竖
帡	
带	横,竖,竖,竖,点2,横撇|横钩,竖,横折钩,竖
帧	竖,横折钩,竖,竖,横,竖,横折,撇,点
帨	
席	点,横,撇,横,竖,竖,横,竖,横折钩,竖
帮	横,横,横,撇,横折折折钩|横撇弯钩,竖,竖,横折钩,竖
帱	竖,横折钩,竖,横,横,横,撇,横,竖钩,点
帷	竖,横折钩,竖,撇,竖,点,横,横,横,竖,横
常	竖,点,撇,点2,横撇|横钩,竖,横折,横,竖,横折钩,竖
帻	竖,横折钩,竖,横,横,竖,横,竖,横折,撇,点
帼	竖,横折钩,竖,竖,横折,横,横,竖,横,点,横
帽	竖,横折钩,竖,竖,横折,横,横,竖,横折,横,横,横
幂	点2,横撇|横钩,竖,横折,横,横,横,撇,捺,竖,横折钩,竖
幄	竖,横折钩,竖,横折,横,撇,横,撇折,点,横,竖,横
幅	竖,横折钩,竖,横,竖,横折,横,竖,横折,横,竖,横
幌	竖,横折钩,竖,竖,横折,横,横,竖,点,撇,横,撇,竖弯钩
幔	竖,横折钩,竖,竖,横折,横,横,竖,横折,竖,竖,横,横撇|横钩,捺
幕	横,竖,竖,竖,横折,横,横,横,撇,捺,竖,横折钩,竖
幖	
幛	竖,横折钩,竖,点,横,点,撇,横,竖,横折,横,横,横,竖
幞	竖,横折钩,竖,竖,竖,点,撇,横,点,撇,横,横,横,撇,捺
幡	竖,横折钩,竖,撇,点,撇,横,竖,撇,捺,竖,横折,横,竖,横
幢	竖,横折钩,竖,点,横,点,撇,横,竖,横折,横,横,竖,横,横
幪	
干	横,横,竖
平	横,点,撇,横,竖
年	撇,横,横,竖,横,竖
并	点,撇,横,横,撇,竖
幸	横,竖,横,点,撇,横,横,竖
幺	撇折,撇折,点
幻	撇折,撇折,点,横折钩
幼	撇折,撇折,点,横折钩,撇
幽	竖,撇折,撇折,点,撇折,撇折,点,竖弯,竖
广	点,横,撇
庄	点,横,撇,横,竖,横
庆	点,横,撇,横,撇,捺
庇	点,横,撇,横,竖提,撇,竖弯钩
床	点,横,撇,横,竖,撇,捺
庋	点,横,撇,横,竖,横撇|横钩,捺
序	点,横,撇,横撇|横钩,点,横撇|横钩,竖钩
庐	点,横,撇,点,横折,横,撇
庑	点,横,撇,横,横,撇,竖弯钩
库	点,横,撇,横,撇折,横,竖
应	点,横,撇,点,点,撇,横
底	点,横,撇,撇,竖提,横,斜钩|卧钩,点
庖	点,横,撇,撇,横折钩,横折,横,竖弯钩
店	点,横,撇,竖,横,竖,横折,横
庙	点,横,撇,竖,横折,横,竖,横
庚	点,横,撇,横折,横,横,撇,捺
府	点,横,撇,撇,竖,横,竖钩,点
庞	点,横,撇,横,撇,竖弯钩,撇,点
废	点,横,撇,撇折,撇,横撇|横钩,捺,点
庠	点,横,撇,点,撇,横,横,横,竖
庤	
庥	点,横,撇,撇,竖,横,竖,撇,捺
度	点,横,撇,横,竖,竖,横,横撇|横钩,捺
座	点,横,撇,撇,点,撇,点,横,竖,横
庭	点,横,撇,撇,横,竖,横,横折折撇,捺
庱	
庳	点,横,撇,撇,竖,横折,横,横,撇,横,竖
庵	点,横,撇,横,撇,捺,竖,横折,横,横,竖弯钩
庶	点,横,撇,横,竖,竖,横,点2,点,点,点
康	点,横,撇,横折,横,横,竖钩,点,提,撇,捺
庸	点,横,撇,横折,横,横,竖,横折钩,横,横,竖
庹	点,横,撇,横,竖,竖,横,横折,横,撇,捺
庼	
庾	点,横,撇,撇,竖,横,横折,横,横,撇,捺
廆	
廉	点,横,撇,点,撇,横,横折,横,横,竖,竖,撇,捺
廊	点,横,撇,点,横折,横,横,竖提,点,横折折折钩|横撇弯钩,竖
廋	
廑	点,横,撇,横,竖,竖,横,竖,横折,横,横,横,竖,横
廒	点,横,撇,横,横,竖,横,横折钩,撇,撇,横,撇,捺
廓	点,横,撇,点,横,竖,横折,横,横撇|横钩,竖钩,提,横折折折钩|横撇弯钩,竖
廖	点,横,撇,横折,点,提,横折,点,提,撇,捺,撇,撇,撇
廙	
廛	点,横,撇,竖,横折,横,横,竖,横,横,撇,点,横,竖,横
廨	点,横,撇,撇,横撇|横钩,撇,横折钩,横,横,竖,横折钩,撇,撇,横,横,竖
廪	点,横,撇,点,横,竖,横折,竖,横折,横,横,横,横,竖钩,撇,点
延	撇,竖,横,竖弯,横折折撇,捺
廷	撇,横,竖,横,横折折撇,捺
建	横折,横,横,横,横,竖,横折折撇,捺
廿	横,竖,竖,横
开	横,横,撇,竖
弁	撇折,点,横,撇,竖
异	横折,横,竖弯钩,横,撇,竖
弃	点,横,撇折,点,横,撇,竖
弄	横,横,竖,横,横,撇,竖
弆	
弇	
弈	点,横,撇,竖钩,撇,点,横,撇,竖
弊	点,撇,竖,横折钩,竖,撇,点,撇,横,撇,捺,横,撇,竖
弋	横,斜钩|卧钩,点
式	横,横,竖,提,斜钩|卧钩,点
弑	撇,点,横,竖钩,撇,点,横,横,竖,提,斜钩|卧钩,点
弓	横折,横,竖折折钩
引	横折,横,竖折折钩,竖
弗	横折,横,竖折折钩,撇,竖
弘	横折,横,竖折折钩,撇折,点
弛	横折,横,竖折折钩,横折钩,竖,竖弯钩
弟	点,撇,横折,横,竖折折钩,竖,撇
张	横折,横,竖折折钩,撇,横,竖提,捺
弢	横折,横,竖折折钩,竖,竖弯,竖,横撇|横钩,捺
弥	横折,横,竖折折钩,撇,横撇|横钩,竖钩,撇,点
弦	横折,横,竖折折钩,点,横,撇折,撇折,点
弧	横折,横,竖折折钩,撇,撇,竖提,点,捺
弨	
弩	撇点,撇,横,横撇|横钩,捺,横折,横,竖折折钩
弭	横折,横,竖折折钩,横,竖,竖,横,横,横
弯	点,横,竖,竖,撇,点,横折,横,竖折折钩
弱	横折,横,竖折折钩,点,提,横折,横,竖折折钩,点,提
弶	
弸	
弹	横折,横,竖折折钩,点,撇,竖,横折,横,横,横,竖
强	横折,横,竖折折钩,竖,横折,横,竖,横折,横,竖,横,点
弼	横折,横,竖折折钩,横,撇,竖,横折,横,横,横折,横,竖折折钩
彀	横,竖,横,点2,横撇|横钩,横,横折,横,竖折折钩,撇,横折折|横折弯,横撇|横钩,捺
归	竖,撇,横折,横,横
当	竖,点,撇,横折,横,横
录	横折,横,横,竖钩,点,提,撇,捺
彖	撇折,横撇|横钩,横,撇,弯钩,撇,撇,撇,捺
彗	横,横,横,竖,横,横,横,竖,横折,横,横
彘	撇折,横撇|横钩,横,横,竖提,撇,横,横,撇,点,撇,竖弯钩
彝	撇折,横撇|横钩,横,点,撇,横,竖,撇,点,撇折,撇折,点,竖钩,撇,点,横,撇,竖
彟	
形	横,横,撇,竖,撇,撇,撇
彤	撇,横折钩,点,横,撇,撇,撇
彦	点,横,点,撇,横,撇,撇,撇,撇
彧	横,竖,横折,横,提,斜钩|卧钩,撇,撇,撇,点
彩	撇,点,点,撇,横,竖,撇,点,撇,撇,撇
彪	竖,横,横撇|横钩,撇,横,竖弯钩,撇,横斜钩,撇,撇,撇
彬	横,竖,撇,点,横,竖,撇,点,撇,撇,撇
彭	横,竖,横,竖,横折,横,点,撇,提,撇,撇,撇
彰	点,横,点,撇,横,竖,横折,横,横,横,竖,撇,撇,撇
影	竖,横折,横,横,点,横,竖,横折,横,竖钩,撇,点,撇,撇,撇
彳	
彷	撇,撇,竖,点,横,横折钩,撇
役	撇,撇,竖,撇,横折折|横折弯,横撇|横钩,捺
彻	撇,撇,竖,横,竖提,横折钩,撇
彼	撇,撇,竖,横撇|横钩,撇,竖,横撇|横钩,捺
往	撇,撇,竖,点,横,横,竖,横
征	撇,撇,竖,横,竖,横,竖,横
徂	撇,撇,竖,竖,横折,横,横,横
径	撇,撇,竖,横撇|横钩,点,横,竖,横
待	撇,撇,竖,横,竖,横,横,竖钩,点
徇	撇,撇,竖,撇,横折钩,竖,横折,横,横
很	撇,撇,竖,横折,横,横,竖提,撇,捺
徉	撇,撇,竖,点,撇,横,横,横,竖
徊	撇,撇,竖,竖,横折,竖,横折,横,横
律	撇,撇,竖,横折,横,横,横,横,竖
徐	撇,撇,竖,撇,捺,横,横,竖钩,撇,点
徒	撇,撇,竖,横,竖,横,竖,横,撇,捺
徕	撇,撇,竖,横,点,撇,横,竖,撇,捺
得	撇,撇,竖,竖,横折,横,横,横,横,竖钩,点
徘	撇,撇,竖,竖,横,横,横,竖,横,横,横
徙	撇,撇,竖,竖,横,竖,横,竖,横,撇,捺
徛	
徜	撇,撇,竖,竖,点,撇,竖,横折钩,竖,横折,横
御	撇,撇,竖,撇,横,横,竖,横,竖,提,横折钩,竖
徨	撇,撇,竖,撇,竖,横折,横,横,横,横,竖,横
循	撇,撇,竖,撇,撇,横,竖,竖,横折,横,横,横
徭	撇,撇,竖,撇,点,点,撇,撇,横,横,竖,竖弯,竖
微	撇,撇,竖,竖,竖弯,竖,横,撇,横折提,撇,横,撇,捺
徵	撇,撇,竖,竖,竖弯,竖,横,横,横,竖,横,撇,横,撇,捺
德	撇,撇,竖,横,撇,竖,横折,竖,竖,横,横,点2,斜钩|卧钩,点,点
徼	撇,撇,竖,撇,竖,横折,横,横,点,横,横折钩,撇,撇,横,撇,捺
徽	撇,撇,竖,竖,竖弯,竖,横,撇折,撇折,点,竖钩,撇,点,撇,横,撇,捺
心	点2,斜钩|卧钩,点,点
必	点2,斜钩|卧钩,点,撇,点
忆	点2,点,竖,横斜钩
忉	点2,点,竖,横折钩,撇
忌	横折,横,竖弯钩,点2,斜钩|卧钩,点,点
忍	横折钩,撇,点2,点2,斜钩|卧钩,点,点
忏	点2,点,竖,撇,横,竖
忐	竖,横,横,点2,斜钩|卧钩,点,点
忑	横,竖,点,点2,斜钩|卧钩,点,点
忒	横,点2,斜钩|卧钩,点,点,斜钩|卧钩,点
忖	点2,点,竖,横,竖钩,点
志	横,竖,横,点2,斜钩|卧钩,点,点
忘	点,横,竖弯,点2,斜钩|卧钩,点,点
忙	点2,点,竖,点,横,竖弯
忝	横,横,撇,捺,竖钩,点2,点,点
忞	
忠	竖,横折,横,竖,点2,斜钩|卧钩,点,点
忡	点2,点,竖,竖,横折,横,竖
忤	点2,点,竖,撇,横,横,竖
忧	点2,点,竖,横,撇,竖弯钩,点
忪	点2,点,竖,撇,捺,撇折,点
快	点2,点,竖,横折,横,撇,捺
忭	点2,点,竖,点,横,竖,点
忮	点2,点,竖,横,竖,横撇|横钩,捺
忱	点2,点,竖,点2,横撇|横钩,撇,竖弯钩
忳	
念	撇,捺,点,横撇|横钩,点2,斜钩|卧钩,点,点
忸	点2,点,竖,横折,竖,横,横
忺	
忻	点2,点,竖,撇,撇,横,竖
忽	撇,横折钩,撇,撇,点2,斜钩|卧钩,点,点
忾	点2,点,竖,撇,横,横,横斜钩
忿	撇,捺,横折钩,撇,点2,斜钩|卧钩,点,点
怀	点2,点,竖,横,撇,竖,点
态	横,撇,捺,点,点2,斜钩|卧钩,点,点
怂	撇,点,撇,捺,点2,斜钩|卧钩,点,点
怃	点2,点,竖,横,横,撇,竖弯钩
怄	点2,点,竖,横,撇,点,竖弯
怅	点2,点,竖,撇,横,竖提,捺
怆	点2,点,竖,撇,捺,横折钩,竖弯钩
怊	点2,点,竖,横折钩,撇,竖,横折,横
怍	点2,点,竖,撇,横,竖,横,横
怎	撇,横,竖,横,横,点2,斜钩|卧钩,点,点
怏	点2,点,竖,竖,横折,横,撇,捺
怒	撇点,撇,横,横撇|横钩,捺,点2,斜钩|卧钩,点,点
怔	点2,点,竖,横,竖,横,竖,横
怕	点2,点,竖,撇,竖,横折,横,横
怖	点2,点,竖,横,撇,竖,横折钩,竖
怙	点2,点,竖,横,竖,竖,横折,横
怛	点2,点,竖,竖,横折,横,横,横
怜	点2,点,竖,撇,捺,点,横撇|横钩,点
思	竖,横折,横,竖,横,点2,斜钩|卧钩,点,点
怠	撇折,点,竖,横折,横,点2,斜钩|卧钩,点,点
怡	点2,点,竖,撇折,点,竖,横折,横
急	撇,横撇|横钩,横折,横,横,点2,斜钩|卧钩,点,点
怦	点2,点,竖,横,点,撇,横,竖
性	点2,点,竖,撇,横,横,竖,横
怨	撇,横撇|横钩,点,横折钩,竖弯钩,点2,斜钩|卧钩,点,点
怩	点2,点,竖,横折,横,撇,撇,竖弯钩
怪	点2,点,竖,横撇|横钩,捺,横,竖,横
怫	点2,点,竖,横折,横,竖折折钩,撇,竖
怯	点2,点,竖,横,竖,横,撇折,点
怵	点2,点,竖,横,竖,撇,捺,点
总	点,撇,竖,横折,横,点2,斜钩|卧钩,点,点
怼	横撇|横钩,点,横,竖钩,点,点2,斜钩|卧钩,点,点
怿	点2,点,竖,横撇|横钩,捺,横,横,竖
恁	撇,竖,撇,横,竖,横,点2,斜钩|卧钩,点,点
恂	点2,点,竖,撇,横折钩,竖,横折,横,横
恃	点2,点,竖,横,竖,横,横,竖钩,点
恋	点,横,竖,竖,撇,点,点2,斜钩|卧钩,点,点
恍	点2,点,竖,竖,点,撇,横,撇,竖弯钩
恐	横,竖,提,撇,横斜钩,点,点2,斜钩|卧钩,点,点
恒	点2,点,竖,横,竖,横折,横,横,横
恓	
恔	
恕	撇点,撇,横,竖,横折,横,点2,斜钩|卧钩,点,点
恙	点,撇,横,横,竖,横,点2,斜钩|卧钩,点,点
恚	横,竖,横,横,竖,横,点2,斜钩|卧钩,点,点
恝	横,横,横,竖,横折钩,撇,点2,斜钩|卧钩,点,点
恢	点2,点,竖,横,撇,点2,撇,撇,捺
恣	点,提,撇,横撇|横钩,撇,捺,点2,斜钩|卧钩,点,点
恤	点2,点,竖,撇,竖,横折,竖,竖,横
恧	横,撇,竖,横折钩,竖,竖,点2,斜钩|卧钩,点,点
恨	点2,点,竖,横折,横,横,竖提,撇,捺
恩	竖,横折,横,撇,点,横,点2,斜钩|卧钩,点,点
恪	点2,点,竖,撇,横撇|横钩,捺,竖,横折,横
恫	点2,点,竖,竖,横折钩,横,竖,横折,横
恬	点2,点,竖,撇,横,竖,竖,横折,横
恭	横,竖,竖,横,撇,捺,竖钩,点2,点,点
息	撇,竖,横折,横,横,横,点2,斜钩|卧钩,点,点
恰	点2,点,竖,撇,捺,横,竖,横折,横
恳	横折,横,横,竖提,撇,捺,点2,斜钩|卧钩,点,点
恶	横,竖,竖,点,撇,横,点2,斜钩|卧钩,点,点
恸	点2,点,竖,横,横,撇折,点,横折钩,撇
恹	点2,点,竖,横,撇,横,撇,捺,点
恺	点2,点,竖,竖,竖弯,竖,横折,横,竖弯钩
恻	点2,点,竖,竖,横折,撇,点,竖,竖钩
恼	点2,点,竖,点,横,撇,点,竖弯,竖
恽	点2,点,竖,点2,横撇|横钩,横,撇折,横,竖
恿	横撇|横钩,点,竖,横折钩,横,横,竖,点2,斜钩|卧钩,点,点
悃	点2,点,竖,竖,横折,横,竖,撇,点,横
悄	点2,点,竖,竖,点,撇,竖,横折钩,横,横
悆	
悈	
悉	撇,点,撇,横,竖,撇,捺,点2,斜钩|卧钩,点,点
悌	点2,点,竖,点,撇,横折,横,竖折折钩,竖,撇
悍	点2,点,竖,竖,横折,横,横,横,横,竖
悒	点2,点,竖,竖,横折,横,横折,竖,横,竖弯钩
悔	点2,点,竖,撇,横,竖弯,横折钩,点,横,点
悖	点2,点,竖,横,竖,点2,横撇|横钩,横撇|横钩,竖钩,横
悚	点2,点,竖,横,竖,横折,横,竖,撇,捺
悛	点2,点,竖,撇折,点,撇,点,撇,横撇|横钩,捺
悝	点2,点,竖,竖,横折,横,横,竖,横,横
悟	点2,点,竖,横,竖,横折,横,竖,横折,横
悠	撇,竖,竖,撇,横,撇,捺,点2,斜钩|卧钩,点,点
悢	
患	竖,横折,横,竖,横折,横,竖,点2,斜钩|卧钩,点,点
悦	点2,点,竖,点,撇,竖,横折,横,撇,竖弯钩
您	撇,竖,撇,横撇|横钩,竖钩,撇,点,点2,斜钩|卧钩,点,点
悫	横,竖,横,点2,横撇|横钩,撇,横斜钩,点2,斜钩|卧钩,点,点
悬	竖,横折,横,横,横,撇折,点,点2,斜钩|卧钩,点,点
悭	点2,点,竖,竖,竖,横撇|横钩,捺,横,竖,横
悯	点2,点,竖,点,竖,横折钩,点,横,撇,点
悰	
悱	点2,点,竖,竖,横,横,横,竖,横,横,横
悲	竖,横,横,横,竖,横,横,横,点2,斜钩|卧钩,点,点
悴	点2,点,竖,点,横,撇,点,撇,点,横,竖
悸	点2,点,竖,撇,横,竖,撇,捺,横撇|横钩,竖钩,横
悻	点2,点,竖,横,竖,横,点,撇,横,横,竖
悼	点2,点,竖,竖,横,竖,横折,横,横,横,竖
情	点2,点,竖,横,横,竖,横,竖,横折钩,横,横
惆	点2,点,竖,撇,横折钩,横,竖,横,竖,横折,横
惇	点2,点,竖,点,横,竖,横折,横,横撇|横钩,竖钩,横
惊	点2,点,竖,点,横,竖,横折,横,竖钩,撇,点
惋	点2,点,竖,点,点2,横撇|横钩,撇,横撇|横钩,点,横折钩,竖弯钩
惎	
惑	横,竖,横折,横,提,斜钩|卧钩,撇,点,点2,斜钩|卧钩,点,点
惔	
惕	点2,点,竖,竖,横折,横,横,撇,横折钩,撇,撇
惘	点2,点,竖,竖,横折钩,点,撇,横,点,横,竖弯
惙	
惚	点2,点,竖,撇,横折钩,撇,撇,点2,斜钩|卧钩,点,点
惛	
惜	点2,点,竖,横,竖,竖,横,竖,横折,横,横
惝	点2,点,竖,竖,点,撇,竖,横折钩,竖,横折,横
惟	点2,点,竖,撇,竖,点,横,横,横,竖,横
惠	横,竖,横折,横,横,竖,横,点,点2,斜钩|卧钩,点,点
惦	点2,点,竖,点,横,撇,竖,横,竖,横折,横
惧	点2,点,竖,竖,横折,横,横,横,横,撇,点
惨	点2,点,竖,撇折,点,横,撇,捺,撇,撇,撇
惩	撇,撇,竖,横,竖,横,竖,横,点2,斜钩|卧钩,点,点
惫	撇,横撇|横钩,捺,竖,横折,横,竖,横,点2,斜钩|卧钩,点,点
惬	点2,点,竖,横,横,点,撇,横,撇,点,竖弯
惭	点2,点,竖,横,撇折,竖,提,撇,撇,横,竖
惮	点2,点,竖,点,撇,竖,横折,横,横,横,竖
惯	点2,点,竖,竖弯,横折,竖,横,竖,横折,撇,点
惰	点2,点,竖,横,撇,横,竖,横,竖,横折钩,横,横
想	横,竖,撇,点,竖,横折,横,横,横,点2,斜钩|卧钩,点,点
惴	点2,点,竖,竖,竖弯,竖,横,撇,竖,横折钩,竖,竖
惶	点2,点,竖,撇,竖,横折,横,横,横,横,竖,横
惹	横,竖,竖,横,撇,竖,横折,横,点2,斜钩|卧钩,点,点
惺	点2,点,竖,竖,横折,横,横,撇,横,横,竖,横
愀	点2,点,竖,撇,横,竖,撇,点,点2,撇,撇,捺
愁	撇,横,竖,撇,点,点2,撇,撇,捺,点2,斜钩|卧钩,点,点
愃	
愆	撇,撇,竖,点,点,提,横,横,竖钩,点2,斜钩|卧钩,点,点
愈	撇,捺,横,竖,横折钩,横,横,竖,竖钩,点2,斜钩|卧钩,点,点
愉	点2,点,竖,撇,捺,横,竖,横折钩,横,横,竖,竖钩
愍	横折,横,竖提,横,斜钩|卧钩,撇,横,撇,捺,点2,斜钩|卧钩,点,点
愎	点2,点,竖,撇,横,竖,横折,横,横,撇,横撇|横钩,捺
意	点,横,点,撇,横,竖,横折,横,横,点2,斜钩|卧钩,点,点
愐	
愔	
愕	点2,点,竖,竖,横折,横,竖,横折,横,横,横,竖折折钩
愚	竖,横折,横,横,竖,横折钩,竖,提,点,点2,斜钩|卧钩,点,点
感	横,撇,横,竖,横折,横,斜钩|卧钩,撇,点,点2,斜钩|卧钩,点,点
愠	点2,点,竖,竖,横折,横,横,竖,横折,竖,竖,横
愣	点2,点,竖,竖,横折,竖,竖,横,点,横,横折钩,撇
愤	点2,点,竖,横,竖,横,竖,竖,竖,横折,撇,点
愦	点2,点,竖,竖,横折,横,竖,横,竖,横折,撇,点
愧	点2,点,竖,撇,竖,横折,横,横,撇,竖弯钩,撇折,点
愫	点2,点,竖,横,横,竖,横,撇折,撇折,点,竖钩,撇,点
愭	
愿	横,撇,撇,竖,横折,横,横,竖钩,撇,点,点2,斜钩|卧钩,点,点
慆	
慈	点,撇,横,撇折,撇折,点,撇折,撇折,点,点2,斜钩|卧钩,点,点
慊	点2,点,竖,点,撇,横,横折,横,横,竖,竖,撇,捺
慌	点2,点,竖,横,竖,竖,点,横,竖弯,撇,竖,竖弯钩
慎	点2,点,竖,横,竖,竖,横折,横,横,横,横,撇,点
慑	点2,点,竖,横,竖,竖,横,横,横,横撇|横钩,点,横撇|横钩,捺
慕	横,竖,竖,竖,横折,横,横,横,撇,捺,竖钩,点2,点,点
慝	横,横,竖,竖,横,撇,竖,横折,横,竖弯,点2,斜钩|卧钩,点,点
慢	点2,点,竖,竖,横折,横,横,竖,横折,竖,竖,横,横撇|横钩,捺
慥	
慧	横,横,横,竖,横,横,横,竖,横折,横,横,点2,斜钩|卧钩,点,点
慨	点2,点,竖,横折,横,横,竖提,点,横,撇折,撇,竖弯钩
慬	
慭	
慰	横折,横,撇,横,横,竖钩,撇,点,横,竖钩,点,点2,斜钩|卧钩,点,点
慵	点2,点,竖,点,横,撇,横折,横,横,竖,横折钩,横,横,竖
慷	点2,点,竖,点,横,撇,横折,横,横,竖钩,点,提,撇,捺
憋	点,撇,竖,横折钩,竖,撇,点,撇,横,撇,捺,点2,斜钩|卧钩,点,点
憎	点2,点,竖,点,撇,竖,横折,竖,点,撇,横,竖,横折,横,横
憔	点2,点,竖,撇,竖,点,横,横,横,竖,横,点2,点,点,点
憕	
憙	
憧	点2,点,竖,点,横,点,撇,横,竖,横折,横,横,竖,横,横
憨	横撇|横钩,横,竖,竖,横,横,提,撇,横,撇,捺,点2,斜钩|卧钩,点,点
憩	撇,横,竖,竖,横折,横,撇,竖,横折,横,横,横,点2,斜钩|卧钩,点,点
憬	点2,点,竖,竖,横折,横,横,点,横,竖,横折,横,竖钩,撇,点
憭	
憷	点2,点,竖,横,竖,撇,点,横,竖,撇,点,横撇|横钩,竖,横,撇,捺
憺	
憾	点2,点,竖,横,撇,横,竖,横折,横,斜钩|卧钩,撇,点,点2,斜钩|卧钩,点,点
懂	点2,点,竖,横,竖,竖,撇,横,竖,横折,横,横,竖,横,横
懈	点2,点,竖,撇,横撇|横钩,撇,横折钩,横,横,竖,横折钩,撇,撇,横,横,竖
懊	点2,点,竖,撇,竖,横折,点,撇,横,竖,撇,点,横,撇,捺
懋	横,竖,撇,点,横撇|横钩,点,横撇|横钩,竖钩,撇,横,竖,撇,捺,点2,斜钩|卧钩,点,点
懑	点,点,提,横,竖,竖,横,竖,横折钩,撇,点,撇,点,点2,斜钩|卧钩,点,点
懒	点2,点,竖,横,竖,横折,横,竖,撇,点,撇,横撇|横钩,竖,横折,撇,点
懔	点2,点,竖,点,横,竖,横折,竖,横折,横,横,横,横,竖钩,撇,点
懦	点2,点,竖,横,点2,横撇|横钩,竖,点,点,点,点,横,撇,竖,横折钩,竖,竖
懵	点2,点,竖,横,竖,竖,竖,横折,竖,竖,横,点2,横撇|横钩,竖,横折,横,横,横
懿	横,竖,横,点2,横撇|横钩,横,竖,横折,横,点,撇,提,点,提,撇,横撇|横钩,撇,捺,点2,斜钩|卧钩,点,点
戆	点,横,点,撇,横,竖,横折,横,横,横,竖,撇,横撇|横钩,捺,横,竖,横,竖,横折,撇,点,点2,斜钩|卧钩,点,点
戈	横,斜钩|卧钩,撇,点
戊	横,撇,斜钩|卧钩,撇,点
戋	横,横,斜钩|卧钩,撇,点
戌	横,撇,横,斜钩|卧钩,撇,点
戍	横,撇,点,斜钩|卧钩,撇,点
戎	横,横,撇,斜钩|卧钩,撇,点
戏	横撇|横钩,点,横,斜钩|卧钩,撇,点
成	横,撇,横折钩,斜钩|卧钩,撇,点
我	撇,横,竖钩,提,斜钩|卧钩,撇,点
戒	横,横,撇,竖,斜钩|卧钩,撇,点
戕	竖弯,竖,横,撇,横,斜钩|卧钩,撇,点
或	横,竖,横折,横,提,斜钩|卧钩,撇,点
戗	撇,点,横折钩,竖弯钩,横,斜钩|卧钩,撇,点
战	竖,横,竖,横折,横,横,斜钩|卧钩,撇,点
戚	横,撇,竖,横,横,竖钩,撇,点,斜钩|卧钩,撇,点
戛	横,撇,竖,横折,横,横,横,横,斜钩|卧钩,撇,点
戟	横,竖,竖,横折,横,横,横,竖,横,斜钩|卧钩,撇,点
戡	横,竖,竖,横,横,横,撇,点,竖弯,横,斜钩|卧钩,撇,点
戢	竖,横折,横,横,竖,竖,横,横,提,斜钩|卧钩,撇,点
戣	
戤	横折折折钩|横撇弯钩,撇,横撇|横钩,点,竖,横折,竖,竖,提,横,斜钩|卧钩,撇,点
戥	竖,横折,横,横,撇,横,横,竖,提,横,斜钩|卧钩,撇,点
截	横,竖,横,撇,竖,点,横,横,横,竖,横,斜钩|卧钩,撇,点
戬	横,竖,竖,点,撇,横,竖,横折,横,横,横,斜钩|卧钩,撇,点
戭	
戮	横折,点,提,横折,点,提,撇,点,撇,撇,撇,横,斜钩|卧钩,撇,点
戳	横折,点,提,横折,点,提,撇,竖,点,横,横,横,竖,横,横,斜钩|卧钩,撇,点
戴	横,竖,横,竖,横折,横,竖,横,横,竖,竖,横,撇,点,斜钩|卧钩,撇,点
户	点,横折,横,撇
戽	点,横折,横,撇,点,点,横,竖
戾	点,横折,横,撇,横,撇,捺,点
房	点,横折,横,撇,点,横,横折钩,撇
所	撇,撇,横折,横,撇,撇,横,竖
扁	点,横折,横,撇,竖,横折钩,横,竖,竖
扂	
扃	点,横折,横,撇,竖,横折钩,竖,横折,横
扅	
扆	
扇	点,横折,横,撇,横折钩,点,提,横折钩,点,提
扈	点,横折,横,撇,竖,横折,横,横折,竖,横,竖弯钩
扉	点,横折,横,撇,竖,横,横,横,竖,横,横,横
扊	
手	撇,横,横,竖钩
才	横,竖钩,撇
扎	横,竖钩,提,竖弯钩
扑	横,竖钩,提,竖,点
扒	横,竖钩,提,撇,捺
打	横,竖钩,提,横,竖钩
扔	横,竖钩,提,横折折折钩|横撇弯钩,撇
托	横,竖钩,提,撇,横,竖弯钩
扛	横,竖钩,提,横,竖,横
扞	
扣	横,竖钩,提,竖,横折,横
扦	横,竖钩,提,撇,横,竖
执	横,竖钩,提,撇,横斜钩,点
扩	横,竖钩,提,点,横,撇
扪	横,竖钩,提,点,竖,横折钩
扫	横,竖钩,提,横折,横,横
扬	横,竖钩,提,横折折折钩|横撇弯钩,撇,撇
扭	横,竖钩,提,横折,竖,横,横
扮	横,竖钩,提,撇,捺,横折钩,撇
扯	横,竖钩,提,竖,横,竖,横
扰	横,竖钩,提,横,撇,竖弯钩,点
扳	横,竖钩,提,撇,撇,横撇|横钩,捺
扶	横,竖钩,提,横,横,撇,捺
批	横,竖钩,提,横,竖提,撇,竖弯钩
扺	
扼	横,竖钩,提,横,撇,横折钩,竖弯钩
扽	
找	横,竖钩,提,横,斜钩|卧钩,撇,点
承	横撇|横钩,竖钩,横,横,横,横撇|横钩,撇,捺
技	横,竖钩,提,横,竖,横撇|横钩,捺
抃	
抄	横,竖钩,提,竖,撇,点,撇
抉	横,竖钩,提,横折,横,撇,捺
把	横,竖钩,提,横折,竖,横,竖弯钩
抑	横,竖钩,提,撇,竖提,横折钩,竖
抒	横,竖钩,提,横撇|横钩,点,横撇|横钩,竖钩
抓	横,竖钩,提,撇,撇,竖,捺
抔	
投	横,竖钩,提,撇,横折折|横折弯,横撇|横钩,捺
抖	横,竖钩,提,点,点,横,竖
抗	横,竖钩,提,点,横,撇,横斜钩
折	横,竖钩,提,撇,撇,横,竖
抚	横,竖钩,提,横,横,撇,竖弯钩
抛	横,竖钩,提,撇,横斜钩,横折钩,撇
抟	横,竖钩,提,横,横,竖折撇|竖折折,点
抠	横,竖钩,提,横,撇,点,竖弯
抡	横,竖钩,提,撇,捺,撇,竖弯钩
抢	横,竖钩,提,撇,捺,横折钩,竖弯钩
护	横,竖钩,提,点,横折,横,撇
报	横,竖钩,提,横折钩,竖,横撇|横钩,捺
抨	横,竖钩,提,横,点,撇,横,竖
披	横,竖钩,提,横撇|横钩,撇,竖,横撇|横钩,捺
抬	横,竖钩,提,撇折,点,竖,横折,横
抱	横,竖钩,提,撇,横折钩,横折,横,竖弯钩
抵	横,竖钩,提,撇,竖提,横,斜钩|卧钩,点
抹	横,竖钩,提,横,横,竖,撇,捺
抻	横,竖钩,提,竖,横折,横,横,竖
押	横,竖钩,提,竖,横折,横,横,竖
抽	横,竖钩,提,竖,横折,横,竖,横
抿	横,竖钩,提,横折,横,竖提,横,斜钩|卧钩
拂	横,竖钩,提,横折,横,竖折折钩,撇,竖
拃	
拄	横,竖钩,提,点,横,横,竖,横
担	横,竖钩,提,竖,横折,横,横,横
拆	横,竖钩,提,撇,撇,横,竖,点
拇	横,竖钩,提,竖弯,横折钩,点,横,点
拈	横,竖钩,提,竖,横,竖,横折,横
拉	横,竖钩,提,点,横,点,撇,横
拊	横,竖钩,提,撇,竖,横,竖钩,点
拌	横,竖钩,提,点,撇,横,横,竖
拍	横,竖钩,提,撇,竖,横折,横,横
拎	横,竖钩,提,撇,捺,点,横撇|横钩,点
拐	横,竖钩,提,竖,横折,横,横折钩,撇
拒	横,竖钩,提,横,横折,横,竖弯
拓	横,竖钩,提,横,撇,竖,横折,横
拔	横,竖钩,提,横,撇,横撇|横钩,捺,点
拖	横,竖钩,提,撇,横,横折钩,竖,竖弯钩
拗	横,竖钩,提,撇折,撇折,点,横折钩,撇
拘	横,竖钩,提,撇,横折钩,竖,横折,横
拙	横,竖钩,提,竖弯,竖,竖,竖弯,竖
招	横,竖钩,提,横折钩,撇,竖,横折,横
拜	撇,横,横,撇,横,横,横,横,竖
拟	横,竖钩,提,竖提,点,撇,点
拢	横,竖钩,提,横,撇,竖弯钩,撇,点
拣	横,竖钩,提,横,撇折,横折钩,撇,点
拤	
拥	横,竖钩,提,撇,横折钩,横,横,竖
拦	横,竖钩,提,点,撇,横,横,横
拧	横,竖钩,提,点,点2,横撇|横钩,横,竖钩
拨	横,竖钩,提,撇折,撇,横撇|横钩,捺,点
择	横,竖钩,提,横撇|横钩,捺,横,横,竖
括	横,竖钩,提,撇,横,竖,竖,横折,横
拭	横,竖钩,提,横,横,竖,提,斜钩|卧钩,点
拮	横,竖钩,提,横,竖,横,竖,横折,横
拯	横,竖钩,提,横撇|横钩,竖钩,横撇|横钩,撇,捺,横
拱	横,竖钩,提,横,竖,竖,横,撇,点
拳	点,撇,横,横,撇,捺,撇,横,横,竖钩
拴	横,竖钩,提,撇,捺,横,横,竖,横
拶	横,竖钩,提,撇点,撇点,撇点,撇,横撇|横钩,点
拷	横,竖钩,提,横,竖,横,撇,横,竖折折钩
拼	横,竖钩,提,点,撇,横,横,撇,竖
拽	横,竖钩,提,竖,横折,横,横,斜钩|卧钩,撇
拾	横,竖钩,提,撇,捺,横,竖,横折,横
拿	撇,捺,横,竖,横折,横,撇,横,横,竖钩
持	横,竖钩,提,横,竖,横,横,竖钩,点
挂	横,竖钩,提,横,竖,横,横,竖,横
指	横,竖钩,提,撇,竖弯钩,竖,横折,横,横
挈	横,横,横,竖,横折钩,撇,撇,横,横,竖钩
按	横,竖钩,提,点,点2,横撇|横钩,撇点,撇,横
挎	横,竖钩,提,横,撇,捺,横,横,竖折折钩
挑	横,竖钩,提,撇,点,提,竖弯钩,撇,点
挓	
挖	横,竖钩,提,点,点2,横撇|横钩,撇,点,横斜钩
挚	横,竖钩,提,撇,横斜钩,点,撇,横,横,竖钩
挛	点,横,竖,竖,撇,点,撇,横,横,竖钩
挝	横,竖钩,提,横,竖钩,点,点,横折折撇,捺
挞	横,竖钩,提,横,撇,点,点,横折折撇,捺
挟	横,竖钩,提,横,点,撇,横,撇,捺
挠	横,竖钩,提,横,斜钩|卧钩,撇,横,撇,竖弯钩
挡	横,竖钩,提,竖,点,撇,横折,横,横
挣	横,竖钩,提,撇,横撇|横钩,横折,横,横,竖钩
挤	横,竖钩,提,点,横,撇,捺,撇,竖
挥	横,竖钩,提,点2,横撇|横钩,横,撇折,横,竖
挦	
挨	横,竖钩,提,撇折,点,撇,横,横,撇,捺
挪	横,竖钩,提,横折钩,横,横,撇,横折折折钩|横撇弯钩,竖
挫	横,竖钩,提,撇,点,撇,点,横,竖,横
振	横,竖钩,提,横,撇,横,横,竖提,撇,捺
挲	点,点,提,竖,撇,点,撇,撇,横,横,竖钩
挹	横,竖钩,提,竖,横折,横,横折,竖,横,竖弯钩
挺	横,竖钩,提,撇,横,竖,横,横折折撇,捺
挽	横,竖钩,提,撇,横撇|横钩,竖,横折,横,撇,竖弯钩
捂	横,竖钩,提,横,竖,横折,横,竖,横折,横
捃	横,竖钩,提,横折,横,横,撇,竖,横折,横
捅	横,竖钩,提,横撇|横钩,点,竖,横折钩,横,横,竖
捆	横,竖钩,提,竖,横折,横,竖,撇,点,横
捉	横,竖钩,提,竖,横折,横,竖,横,撇,捺
捋	横,竖钩,提,撇,点,点,撇,横,竖钩,点
捌	横,竖钩,提,竖,横折,横,横折钩,撇,竖,竖钩
捍	横,竖钩,提,竖,横折,横,横,横,横,竖
捎	横,竖钩,提,竖,点,撇,竖,横折钩,横,横
捏	横,竖钩,提,竖,横折,横,横,横,竖,横
捐	横,竖钩,提,竖,横折,横,竖,横折钩,横,横
捕	横,竖钩,提,横,竖,横折钩,横,横,竖,点
捞	横,竖钩,提,横,竖,竖,点2,横撇|横钩,横折钩,撇
损	横,竖钩,提,竖,横折,横,竖,横折,撇,点
捡	横,竖钩,提,撇,捺,横,点,点,撇,横
换	横,竖钩,提,撇,横撇|横钩,竖,横折,横,撇,捺
捣	横,竖钩,提,撇,横折钩,点,竖折折钩,竖,竖弯,竖
捧	横,竖钩,提,横,横,横,撇,捺,横,横,竖
捩	横,竖钩,提,点,横折,横,撇,横,撇,捺,点
捭	横,竖钩,提,撇,竖,横折,横,横,撇,横,竖
据	横,竖钩,提,横折,横,撇,横,竖,竖,横折,横
捯	横,竖钩,提,横,撇折,点,横,竖,提,竖,竖钩
捶	横,竖钩,提,撇,横,竖,横,竖,竖,横,横
捷	横,竖钩,提,横,横折,横,横,竖,横,撇,捺
捺	横,竖钩,提,横,撇,捺,横,横,竖钩,撇,点
捻	横,竖钩,提,撇,捺,点,横撇|横钩,点2,斜钩|卧钩,点,点
捽	
掀	横,竖钩,提,撇,撇,横,竖,撇,横撇|横钩,撇,捺
掂	横,竖钩,提,点,横,撇,竖,横,竖,横折,横
掇	横,竖钩,提,横撇|横钩,点,横撇|横钩,点,横撇|横钩,点,横撇|横钩,捺
授	横,竖钩,提,撇,点,点,撇,点2,横撇|横钩,横撇|横钩,捺
掉	横,竖钩,提,竖,横,竖,横折,横,横,横,竖
掊	横,竖钩,提,点,横,点,撇,横,竖,横折,横
掌	竖,点,撇,点2,横撇|横钩,竖,横折,横,撇,横,横,竖钩
掎	横,竖钩,提,横,撇,点,横,竖,横折,横,竖钩
掏	横,竖钩,提,撇,横折钩,撇,横,横,竖,竖弯,竖
掐	横,竖钩,提,撇,横撇|横钩,撇,竖,横,横折,横,横
排	横,竖钩,提,竖,横,横,横,竖,横,横,横
掖	横,竖钩,提,点,横,撇,竖,撇,横撇|横钩,点,捺
掘	横,竖钩,提,横折,横,撇,竖弯,竖,竖,竖弯,竖
掞	
掠	横,竖钩,提,点,横,竖,横折,横,竖钩,撇,点
探	横,竖钩,提,点2,横撇|横钩,撇,点,横,竖,撇,捺
掣	撇,横,横,竖,横折钩,竖,竖,竖钩,撇,横,横,竖钩
接	横,竖钩,提,点,横,点,撇,横,撇点,撇,横
控	横,竖钩,提,点,点2,横撇|横钩,撇,点,横,竖,横
推	横,竖钩,提,撇,竖,点,横,横,横,竖,横
掩	横,竖钩,提,横,撇,捺,竖,横折,横,横,竖弯钩
措	横,竖钩,提,横,竖,竖,横,竖,横折,横,横
掬	横,竖钩,提,撇,横折钩,点,撇,横,竖,撇,点
掭	横,竖钩,提,横,横,撇,捺,竖钩,点2,点,点
掮	横,竖钩,提,点,横折,横,撇,竖,横折钩,横,横
掰	撇,横,横,撇,撇,捺,横折钩,撇,撇,横,横,竖钩
掳	横,竖钩,提,竖,横,横撇|横钩,撇,横,竖弯钩,横折钩,撇
掴	横,竖钩,提,竖,横折,横,横,竖,横,点,横
掷	横,竖钩,提,点,撇,横,横,撇,点,横折折折钩|横撇弯钩,竖
掸	横,竖钩,提,点,撇,竖,横折,横,横,横,竖
掺	横,竖钩,提,撇折,点,横,撇,捺,撇,撇,撇
掼	横,竖钩,提,竖弯,横折,竖,横,竖,横折,撇,点
掾	横,竖钩,提,撇折,横撇|横钩,横,撇,弯钩,撇,撇,撇,捺
揄	横,竖钩,提,撇,捺,横,竖,横折钩,横,横,竖,竖钩
揆	横,竖钩,提,横撇|横钩,点,撇,撇,捺,横,横,撇,点
揉	横,竖钩,提,横撇|横钩,点,横撇|横钩,竖钩,撇,横,竖,撇,捺
揍	横,竖钩,提,横,横,横,撇,捺,横,横,撇,点
描	横,竖钩,提,横,竖,竖,竖,横折,横,竖,横
提	横,竖钩,提,竖,横折,横,横,横,竖,横,撇,捺
插	横,竖钩,提,撇,横,竖,撇,竖,横,横折,横,横
揕	
揖	横,竖钩,提,竖,横折,横,横,竖,竖,横,横,横
揠	横,竖钩,提,横,竖,横折,横,横,撇点,撇,横,竖弯
握	横,竖钩,提,横折,横,撇,横,撇折,点,横,竖,横
揣	横,竖钩,提,竖,竖弯,竖,横,撇,竖,横折钩,竖,竖
揩	横,竖钩,提,横,竖提,撇,竖弯钩,撇,竖,横折,横,横
揪	横,竖钩,提,撇,横,竖,撇,点,点2,撇,撇,捺
揭	横,竖钩,提,竖,横折,横,横,撇,横折钩,撇,点,竖弯
揳	
援	横,竖钩,提,撇,点,点,撇,横,横,撇,横撇|横钩,捺
揶	横,竖钩,提,横,竖,竖,横,横,提,横折折折钩|横撇弯钩,竖
揸	横,竖钩,提,横,竖,撇,捺,竖,横折,横,横,横
揽	横,竖钩,提,竖,竖,撇,横,点,竖,横折,撇,竖弯钩
揿	横,竖钩,提,撇,横,横,横,竖提,撇,横撇|横钩,撇,捺
搀	横,竖钩,提,撇,横撇|横钩,竖,横折,横,撇,竖弯钩,点,点
搁	横,竖钩,提,点,竖,横折钩,撇,横撇|横钩,捺,竖,横折,横
搂	横,竖钩,提,点,撇,横,竖,撇,捺,撇点,撇,横
搅	横,竖钩,提,点,点,撇,点2,横撇|横钩,竖,横折,撇,竖弯钩
搋	横,竖钩,提,撇,撇,竖,横,横撇|横钩,撇,横,竖弯钩,撇,横斜钩
搌	横,竖钩,提,横折,横,撇,横,竖,竖,横,竖提,撇,捺
搏	横,竖钩,提,横,竖,横折,横,横,竖,点,横,竖钩,点
搐	横,竖钩,提,点,横,撇折,撇折,点,竖,横折,横,竖,横
搒	
搓	横,竖钩,提,点,撇,横,横,横,撇,横,竖,横
搔	横,竖钩,提,横撇|横钩,捺,点,竖,横折,横,竖,横,点
搛	横,竖钩,提,点,撇,横,横折,横,横,竖,竖,撇,捺
搜	横,竖钩,提,撇,竖,横,横折,横,横,竖,横撇|横钩,捺
搞	横,竖钩,提,点,横,竖,横折,横,竖,横折钩,竖,横折,横
搠	横,竖钩,提,点,撇,横,竖弯,竖,撇,撇,横折钩,横,横
搡	横,竖钩,提,横撇|横钩,点,横撇|横钩,点,横撇|横钩,点,横,竖,撇,捺
搦	横,竖钩,提,横折,横,竖折折钩,点,提,横折,横,竖折折钩,点,提
搪	横,竖钩,提,点,横,撇,横折,横,横,竖,竖,横折,横
搬	横,竖钩,提,撇,撇,横折钩,点,横,点,撇,横折折|横折弯,横撇|横钩,捺
搭	横,竖钩,提,横,竖,竖,撇,捺,横,竖,横折,横
搴	点,点2,横撇|横钩,横,横,竖,竖,横,撇,捺,撇,横,横,竖钩
携	横,竖钩,提,撇,竖,点,横,横,横,竖,横,横折折折钩|横撇弯钩,撇
搽	横,竖钩,提,横,竖,竖,撇,捺,横,竖钩,撇,点
摁	横,竖钩,提,竖,横折,横,撇,点,横,点2,斜钩|卧钩,点,点
摄	横,竖钩,提,横,竖,竖,横,横,横,横撇|横钩,点,横撇|横钩,捺
摅	横,竖钩,提,竖,横,横撇|横钩,撇,横,竖弯钩,点2,斜钩|卧钩,点,点
摆	横,竖钩,提,竖,横折,竖,竖,横,横,竖,横,撇折,点
摇	横,竖钩,提,撇,点,点,撇,撇,横,横,竖,竖弯,竖
摈	横,竖钩,提,点,点2,横撇|横钩,撇,竖,横,竖,横,撇,点
摊	横,竖钩,提,横撇|横钩,点,撇,竖,点,横,横,横,竖,横
摏	
摒	横,竖钩,提,横折,横,撇,点,撇,横,横,撇,竖
摔	横,竖钩,提,点,横,撇折,撇折,点,点,提,撇,点,横,竖
摘	横,竖钩,提,点,横,点,撇,竖,横折钩,横,竖,竖,横折,横
摛	
摞	横,竖钩,提,竖,横折,横,竖,横,撇折,撇折,点,竖钩,撇,点
摧	横,竖钩,提,竖,竖弯,竖,撇,竖,点,横,横,横,竖,横
摩	点,横,撇,横,竖,撇,点,横,竖,撇,捺,撇,横,横,竖钩
摭	横,竖钩,提,点,横,撇,横,竖,竖,横,点2,点,点,点
摴	
摸	横,竖钩,提,横,竖,竖,竖,横折,横,横,横,撇,捺
摹	横,竖,竖,竖,横折,横,横,横,撇,捺,撇,横,横,竖钩
摽	
撂	横,竖钩,提,竖,横折,横,竖,横,撇,横撇|横钩,捺,竖,横折,横
撄	横,竖钩,提,竖,横折,撇,点,竖,横折,撇,点,撇点,撇,横
撅	横,竖钩,提,横,撇,点,撇,横,竖弯,横,撇,撇,横撇|横钩,撇,捺
撇	横,竖钩,提,点,撇,竖,横折钩,竖,撇,点,撇,横,撇,捺
撑	横,竖钩,提,竖,点,撇,点2,横撇|横钩,竖,横折,横,撇,横,横,竖钩
撒	横,竖钩,提,横,竖,竖,横,竖,横折钩,横,横,撇,横,撇,捺
撕	横,竖钩,提,横,竖,竖,横,横,横,撇,点,撇,撇,横,竖
撖	横,竖钩,提,横撇|横钩,横,竖,竖,横,横,提,撇,横,撇,捺
撙	横,竖钩,提,点,撇,横,竖,横折,撇,竖弯,横,横,横,竖钩,点
撞	横,竖钩,提,点,横,点,撇,横,竖,横折,横,横,竖,横,横
撤	横,竖钩,提,点,横,撇折,点,竖,横折钩,横,横,撇,横,撇,捺
撩	横,竖钩,提,横,撇,捺,点,撇,竖,横折,横,横,竖钩,撇,点
撬	横,竖钩,提,撇,横,横,竖弯钩,撇,横,横,竖提,撇,横,横,竖弯钩
播	横,竖钩,提,撇,点,撇,横,竖,撇,捺,竖,横折,横,竖,横
撮	横,竖钩,提,竖,横折,横,横,横,竖,竖,横,横,提,横撇|横钩,捺
撰	横,竖钩,提,横折,横,竖弯钩,横折,横,竖弯钩,横,竖,竖,横,撇,点
撵	横,竖钩,提,横,横,撇,点,横,横,撇,捺,横,撇折,横,竖
撷	横,竖钩,提,横,竖,横,竖,横折,横,横,撇,竖,横折,撇,点
撸	横,竖钩,提,撇,横撇|横钩,竖,横折,横,竖,横,横,竖,横折,横,横
撺	横,竖钩,提,点,点2,横撇|横钩,撇,点,竖,横折,横,竖,横折,横,竖
撼	横,竖钩,提,横,撇,横,竖,横折,横,斜钩|卧钩,撇,点,点2,斜钩|卧钩,点,点
擀	横,竖钩,提,横,竖,竖,横折,横,横,横,竖,撇,捺,横,横,竖
擂	横,竖钩,提,横,点2,横撇|横钩,竖,点,点,点,点,竖,横折,横,竖,横
擅	横,竖钩,提,点,横,竖,横折,竖,横折,横,横,竖,横折,横,横,横
操	横,竖钩,提,竖,横折,横,竖,横折,横,竖,横折,横,横,竖,撇,捺
擎	横,竖,竖,撇,横折钩,竖,横折,横,撇,横,撇,捺,撇,横,横,竖钩
擐	横,竖钩,提,竖,横折,竖,竖,横,横,竖,横折,横,撇,竖提,撇,捺
擒	横,竖钩,提,撇,捺,点,横,撇,点,竖弯,竖,竖,横折钩,撇折,点
擘	横折,横,撇,竖,横折,横,点,横,点,撇,横,横,竖,撇,横,横,竖钩
擞	横,竖钩,提,点,撇,横,竖,撇,点,撇点,撇,横,撇,横,撇,捺
擢	横,竖钩,提,横折,点,提,横折,点,提,撇,竖,点,横,横,横,竖,横
擤	横,竖钩,提,撇,竖,横折,横,横,横,竖,横折,横,竖,横,横,撇,竖
擦	横,竖钩,提,点,点2,横撇|横钩,撇,横撇|横钩,点,点,横撇|横钩,捺,横,横,竖钩,撇,点
擿	
攀	横,竖,撇,点,撇,点,撇,点,横,竖,撇,点,横,撇,捺,撇,横,横,竖钩
攉	横,竖钩,提,横,点2,横撇|横钩,竖,点,点,点,点,撇,竖,点,横,横,横,竖,横
攒	横,竖钩,提,撇,横,竖,横,撇,竖提,撇,横,竖,横,撇,竖弯钩,竖,横折,撇,点
攘	横,竖钩,提,点,横,竖,横折,横,竖,横折,横,横,横,竖,竖,横,撇,竖提,撇,捺
攥	横,竖钩,提,撇,横,点,撇,横,点,竖,横折,横,横,横,横,撇,捺,撇折,撇折,点,竖钩,撇,点
攫	横,竖钩,提,竖,横折,横,横,横,竖,横折,横,横,横,撇,竖,点,横,横,横,竖,横,横撇|横钩,捺
攮	横,竖钩,提,横,竖,横折,横,竖,点2,横撇|横钩,竖,横折,横,竖,横折,横,横,横,竖,竖,横,撇,竖提,撇,捺
支	横,竖,横撇|横钩,捺
收	竖提,竖,撇,横,撇,捺
攸	撇,竖,竖,撇,横,撇,捺
改	横折,横,竖提,撇,横,撇,捺
攻	横,竖,提,撇,横,撇,捺
攽	
放	点,横,横折钩,撇,撇,横,撇,捺
政	横,竖,横,竖,提,撇,横,撇,捺
故	横,竖,竖,横折,横,撇,横,撇,捺
效	点,横,撇,点,撇,点,撇,横,撇,捺
敉	点,撇,横,竖,撇,点,撇,横,撇,捺
敌	撇,横,竖,竖,横折,横,撇,横,撇,捺
敏	撇,横,竖弯,横折钩,点,横,点,撇,横,撇,捺
救	横,竖钩,点,提,撇,点,点,撇,横,撇,捺
敔	
敕	横,竖,横折,横,竖,撇,点,撇,横,撇,捺
敖	横,横,竖,横,横折钩,撇,撇,横,撇,捺
教	横,竖,横,撇,横撇|横钩,竖钩,提,撇,横,撇,捺
敛	撇,点,横,点,点,撇,提,撇,横,撇,捺
敝	点,撇,竖,横折钩,竖,撇,点,撇,横,撇,捺
敞	竖,点,撇,竖,横折钩,竖,横折,横,撇,横,撇,捺
敢	横撇|横钩,横,竖,竖,横,横,提,撇,横,撇,捺
散	横,竖,竖,横,竖,横折钩,横,横,撇,横,撇,捺
敦	点,横,竖,横折,横,横撇|横钩,竖钩,提,撇,横,撇,捺
敩	
敫	撇,竖,横折,横,横,点,横,横折钩,撇,撇,横,撇,捺
敬	横,竖,竖,撇,横折钩,竖,横折,横,撇,横,撇,捺
数	点,撇,横,竖,撇,点,撇点,撇,横,撇,横,撇,捺
敲	点,横,竖,横折,横,竖,横折钩,竖,横折,横,竖,横,横撇|横钩,捺
整	横,竖,横折,横,竖,撇,点,撇,横,撇,捺,横,竖,横,竖,横
敷	横,竖,横折,横,横,竖,点,点,横,横折钩,撇,撇,横,撇,捺
文	点,横,撇,捺
斋	点,横,撇,捺,横,撇,竖,横折钩,竖,竖
斌	点,横,撇,点,横,横,竖,横,竖,提,斜钩|卧钩,点
斐	竖,横,横,横,竖,横,横,横,点,横,撇,捺
斑	横,横,竖,提,点,横,撇,点,横,横,竖,横
斓	点,横,撇,点,点,竖,横折钩,横,竖,横折,点,撇,横,竖,撇,点
斗	点,点,横,竖
料	点,撇,横,竖,撇,点,点,点,横,竖
斛	撇,横撇|横钩,撇,横折钩,横,横,竖,点,点,横,竖
斜	撇,点,横,横,竖钩,撇,点,点,点,横,竖
斝	
斟	横,竖,竖,横,横,横,撇,点,竖弯,点,点,横,竖
斠	
斡	横,竖,竖,横折,横,横,横,竖,撇,捺,点,点,横,竖
斤	撇,撇,横,竖
斥	撇,撇,横,竖,点
斧	撇,点,撇,捺,撇,撇,横,竖
斩	横,撇折,竖,提,撇,撇,横,竖
斫	横,撇,竖,横折,横,撇,撇,横,竖
断	点,撇,横,竖,撇,点,竖弯,撇,撇,横,竖
斯	横,竖,竖,横,横,横,撇,点,撇,撇,横,竖
新	点,横,点,撇,横,横,竖钩,撇,点,撇,撇,横,竖
斶	
方	点,横,横折钩,撇
於	点,横,横折钩,撇,撇,捺,点,点
施	点,横,横折钩,撇,撇,横,横折钩,竖,竖弯钩
旁	点,横,点,撇,点2,横撇|横钩,点,横,横折钩,撇
旃	点,横,横折钩,撇,撇,横,撇,横折钩,点,横
旄	点,横,横折钩,撇,撇,横,撇,横,横,竖弯钩
旅	点,横,横折钩,撇,撇,横,撇,竖提,撇,捺
旆	点,横,横折钩,撇,撇,横,横,竖,横折钩,竖
旋	点,横,横折钩,撇,撇,横,横撇|横钩,竖,横,撇,捺
旌	点,横,横折钩,撇,撇,横,撇,横,横,竖,横
旎	点,横,横折钩,撇,撇,横,横折,横,撇,撇,竖弯钩
族	点,横,横折钩,撇,撇,横,撇,横,横,撇,捺
旐	
旒	点,横,横折钩,撇,撇,横,点,横,撇折,点,撇,竖,竖弯钩
旖	点,横,横折钩,撇,撇,横,横,撇,点,横,竖,横折,横,竖钩
旗	点,横,横折钩,撇,撇,横,横,竖,竖,横,横,横,撇,点
旞	
无	横,横,撇,竖弯钩
既	横折,横,横,竖提,点,横,撇折,撇,竖弯钩
日	竖,横折,横,横
旦	竖,横折,横,横,横
旧	竖,竖,横折,横,横
旨	撇,竖弯钩,竖,横折,横,横
早	竖,横折,横,横,横,竖
旬	撇,横折钩,竖,横折,横,横
旭	撇,横斜钩,竖,横折,横,横
旮	撇,横斜钩,竖,横折,横,横
旯	竖,横折,横,横,撇,横斜钩
旰	竖,横折,横,横,横,横,竖
旱	竖,横折,横,横,横,横,竖
旴	
旵	
时	竖,横折,横,横,横,竖钩,点
旷	竖,横折,横,横,点,横,撇
旸	竖,横折,横,横,横折折折钩|横撇弯钩,撇,撇
旺	竖,横折,横,横,横,横,竖,横
旻	竖,横折,横,横,点,横,撇,捺
旿	
昀	竖,横折,横,横,撇,横折钩,点,提
昂	竖,横折,横,横,撇,竖提,横折钩,竖
昃	竖,横折,横,横,横,撇,撇,捺
昄	
昆	竖,横折,横,横,横,竖提,撇,竖弯钩
昇	竖,横折,横,横,撇,横,撇,竖
昈	
昉	竖,横折,横,横,点,横,横折钩,撇
昊	竖,横折,横,横,横,横,撇,捺
昌	竖,横折,横,横,竖,横折,横,横
明	竖,横折,横,横,撇,横折钩,横,横
昏	撇,竖提,横,斜钩|卧钩,竖,横折,横,横
昒	
易	竖,横折,横,横,撇,横折钩,撇,撇
昔	横,竖,竖,横,竖,横折,横,横
昕	竖,横折,横,横,撇,撇,横,竖
昙	竖,横折,横,横,横,横,撇折,点
昝	撇,横撇|横钩,捺,竖,点,竖,横折,横,横
星	竖,横折,横,横,撇,横,横,竖,横
映	竖,横折,横,横,竖,横折,横,撇,捺
昡	
昣	
昤	
春	横,横,横,撇,捺,竖,横折,横,横
昧	竖,横折,横,横,横,横,竖,撇,捺
昨	竖,横折,横,横,撇,横,竖,横,横
昪	
昫	
昭	竖,横折,横,横,横折钩,撇,竖,横折,横
是	竖,横折,横,横,横,竖,横,撇,捺
昱	竖,横折,横,横,点,横,点,撇,横
昳	竖,横折,横,横,撇,横,横,撇,捺
昴	竖,横折,横,横,撇,竖提,撇,横折钩,竖
昵	竖,横折,横,横,横折,横,撇,撇,竖弯钩
昶	点,横折钩,横撇|横钩,撇,捺,竖,横折,横,横
昺	竖,横折,横,横,横,竖,横折钩,撇,点
昼	横折,横,撇,捺,竖,横折,横,横,横
昽	
显	竖,横折,横,横,竖,竖,点,撇,横
晁	竖,横折,横,横,撇,点,提,竖弯钩,撇,点
晃	竖,横折,横,横,竖,点,撇,横,撇,竖弯钩
晅	
晊	
晋	横,竖,竖,点,撇,横,竖,横折,横,横
晌	竖,横折,横,横,撇,竖,横折钩,竖,横折,横
晏	竖,横折,横,横,点,点2,横撇|横钩,撇点,撇,横
晐	
晒	竖,横折,横,横,横,竖,横折,撇,竖弯,横
晓	竖,横折,横,横,横,斜钩|卧钩,撇,横,撇,竖弯钩
晔	竖,横折,横,横,撇,竖,撇,竖弯钩,横,竖
晕	竖,横折,横,横,点2,横撇|横钩,横,撇折,横,竖
晖	竖,横折,横,横,点2,横撇|横钩,横,撇折,横,竖
晗	竖,横折,横,横,撇,捺,点,横撇|横钩,竖,横折,横
晙	
晚	竖,横折,横,横,撇,横撇|横钩,竖,横折,横,撇,竖弯钩
晞	竖,横折,横,横,撇,点,横,撇,竖,横折钩,竖
晟	竖,横折,横,横,横,撇,横折钩,斜钩|卧钩,撇,点
晡	竖,横折,横,横,横,竖,横折钩,横,横,竖,点
晢	
晤	竖,横折,横,横,横,竖,横折,横,竖,横折,横
晦	竖,横折,横,横,撇,横,竖弯,横折钩,点,横,点
晨	竖,横折,横,横,横,撇,横,横,竖提,撇,捺
晪	
晫	
普	点,撇,横,竖,竖,点,撇,横,竖,横折,横,横
景	竖,横折,横,横,点,横,竖,横折,横,竖钩,撇,点
晰	竖,横折,横,横,横,竖,撇,点,撇,撇,横,竖
晱	
晴	竖,横折,横,横,横,横,竖,横,竖,横折钩,横,横
晶	竖,横折,横,横,竖,横折,横,横,竖,横折,横,横
晷	竖,横折,横,横,撇,横撇|横钩,捺,竖,点,竖,横折,横
智	撇,横,横,撇,点,竖,横折,横,竖,横折,横,横
晾	竖,横折,横,横,点,横,竖,横折,横,竖钩,撇,点
暂	横,撇折,竖,提,撇,撇,横,竖,竖,横折,横,横
暄	竖,横折,横,横,点,点2,横撇|横钩,横,竖,横折,横,横,横
暅	
暇	竖,横折,横,横,横折,横,竖,横,横,横折,横,横撇|横钩,捺
暌	竖,横折,横,横,横撇|横钩,点,撇,撇,捺,横,横,撇,点
暑	竖,横折,横,横,横,竖,横,撇,竖,横折,横,横
暕	
暖	竖,横折,横,横,撇,点,点,撇,横,横,撇,横撇|横钩,捺
暗	竖,横折,横,横,点,横,点,撇,横,竖,横折,横,横
暝	竖,横折,横,横,点2,横撇|横钩,竖,横折,横,横,点,横,撇,点
暧	竖,横折,横,横,撇,点,点,撇,点2,横撇|横钩,横,撇,横撇|横钩,捺
暨	横折,横,横,竖提,点,横,撇折,撇,竖弯钩,竖,横折,横,横,横
暮	横,竖,竖,竖,横折,横,横,横,撇,捺,竖,横折,横,横
暲	
暴	竖,横折,横,横,横,竖,竖,横,撇,捺,竖钩,点,提,撇,点
暵	
暶	
暹	竖,横折,横,横,撇,竖,点,横,横,横,竖,横,点,横折折撇,捺
暾	竖,横折,横,横,点,横,竖,横折,横,横撇|横钩,竖钩,提,撇,横,撇,捺
暿	
曈	竖,横折,横,横,点,横,点,撇,横,竖,横折,横,横,竖,横,横
曌	竖,横折,横,横,撇,横折钩,横,横,点,点2,横撇|横钩,撇,点,横,竖,横
曙	竖,横折,横,横,竖,横折,竖,竖,横,横,竖,横,撇,竖,横折,横,横
曛	竖,横折,横,横,撇,横,竖,横折,点,撇,横,竖,横,横,点2,点,点,点
曜	竖,横折,横,横,横折,点,提,横折,点,提,撇,竖,点,横,横,横,竖,横
曝	竖,横折,横,横,竖,横折,横,横,横,竖,竖,横,撇,捺,竖钩,点,提,撇,点
曦	竖,横折,横,横,点,撇,横,横,竖,横,撇,横,竖,撇,点,横,竖折折钩,斜钩|卧钩,撇,点
曩	竖,横折,横,横,点,横,竖,横折,横,竖,横折,横,横,横,竖,竖,横,撇,竖提,撇,捺
曰	竖,横折,横,横
曲	竖,横折,横,竖,竖,横
曳	竖,横折,横,横,斜钩|卧钩,撇
更	横,竖,横折,横,横,撇,捺
曷	竖,横折,横,横,撇,横折钩,撇,点,竖弯
曹	横,竖,横折,横,竖,竖,横,竖,横折,横,横
曼	竖,横折,横,横,竖,横折,竖,竖,横,横撇|横钩,捺
曾	点,撇,竖,横折,竖,点,撇,横,竖,横折,横,横
替	横,横,撇,点,横,横,撇,捺,竖,横折,横,横
最	竖,横折,横,横,横,竖,竖,横,横,提,横撇|横钩,捺
月	撇,横折钩,横,横
有	横,撇,竖,横折钩,横,横
朋	撇,横折钩,横,横,撇,横折钩,横,横
服	撇,横折钩,横,横,横折钩,竖,横撇|横钩,捺
朏	
朐	撇,横折钩,横,横,撇,横折钩,竖,横折,横
朓	
朔	点,撇,横,竖弯,竖,撇,撇,横折钩,横,横
朕	撇,横折钩,横,横,点,撇,横,横,撇,捺
朗	点,横折,横,横,竖提,点,撇,横折钩,横,横
望	点,横,竖提,撇,横折钩,横,横,横,横,竖,横
朝	横,竖,竖,横折,横,横,横,竖,撇,横折钩,横,横
期	横,竖,竖,横,横,横,撇,点,撇,横折钩,横,横
朦	撇,横折钩,横,横,横,竖,竖,点2,横撇|横钩,横,横,撇,弯钩,撇,撇,撇,捺
木	横,竖,撇,捺
未	横,横,竖,撇,捺
末	横,横,竖,撇,捺
本	横,竖,撇,捺,横
札	横,竖,撇,点,竖弯钩
术	横,竖,撇,捺,点
朱	撇,横,横,竖,撇,捺
朳	
朴	横,竖,撇,点,竖,点
朵	撇,横折折|横折弯,横,竖,撇,捺
朸	
机	横,竖,撇,点,撇,横斜钩
朽	横,竖,撇,点,横,竖折折钩
杀	撇,点,横,竖钩,撇,点
杂	撇,横斜钩,横,竖钩,撇,点
权	横,竖,撇,点,横撇|横钩,捺
杄	
杆	横,竖,撇,点,横,横,竖
杈	横,竖,撇,点,横撇|横钩,捺,点
杉	横,竖,撇,点,撇,撇,撇
杌	横,竖,撇,点,横,撇,竖弯钩
李	横,竖,撇,捺,横撇|横钩,竖钩,横
杏	横,竖,撇,捺,竖,横折,横
材	横,竖,撇,点,横,竖钩,撇
村	横,竖,撇,点,横,竖钩,点
杓	横,竖,撇,点,撇,横折钩,点
杕	
杖	横,竖,撇,点,横,撇,捺
杙	
杜	横,竖,撇,点,横,竖,横
杞	横,竖,撇,点,横折,横,竖弯钩
束	横,竖,横折,横,竖,撇,捺
杠	横,竖,撇,点,横,竖,横
条	撇,横撇|横钩,捺,横,竖钩,撇,点
来	横,点,撇,横,竖,撇,捺
杧	
杨	横,竖,撇,点,横折折折钩|横撇弯钩,撇,撇
杩	横,竖,撇,点,横折,竖折折钩,横
杪	横,竖,撇,点,竖,撇,点,撇
杭	横,竖,撇,点,点,横,撇,横斜钩
杯	横,竖,撇,点,横,撇,竖,点
杰	横,竖,撇,捺,点2,点,点,点
杲	竖,横折,横,横,横,竖,撇,捺
杳	横,竖,撇,捺,竖,横折,横,横
杵	横,竖,撇,点,撇,横,横,竖
杷	横,竖,撇,点,横折,竖,横,竖弯钩
杻	
杼	横,竖,撇,点,横撇|横钩,点,横撇|横钩,竖钩
松	横,竖,撇,点,撇,捺,撇折,点
板	横,竖,撇,点,撇,撇,横撇|横钩,捺
极	横,竖,撇,点,撇,横折折撇,捺
构	横,竖,撇,点,撇,横折钩,撇折,点
枅	
枇	横,竖,撇,点,横,竖提,撇,竖弯钩
枉	横,竖,撇,点,横,横,竖,横
枋	横,竖,撇,点,点,横,横折钩,撇
枍	
析	横,竖,撇,点,撇,撇,横,竖
枕	横,竖,撇,点,点2,横撇|横钩,撇,竖弯钩
林	横,竖,撇,点,横,竖,撇,捺
枘	横,竖,撇,点,竖,横折钩,撇,点
枚	横,竖,撇,点,撇,横,撇,捺
果	竖,横折,横,横,横,竖,撇,捺
枝	横,竖,撇,点,横,竖,横撇|横钩,捺
枞	横,竖,撇,点,撇,点,撇,捺
枢	横,竖,撇,点,横,撇,点,竖弯
枣	横,竖,横折,竖,撇,捺,点,点
枥	横,竖,撇,点,横,撇,横折钩,撇
枧	横,竖,撇,点,竖,横折,撇,竖弯钩
枨	横,竖,撇,点,撇,横,竖提,捺
枪	横,竖,撇,点,撇,捺,横折钩,竖弯钩
枫	横,竖,撇,点,撇,横斜钩,撇,点
枭	撇,横折钩,点,竖折折钩,横,竖,撇,捺
枯	横,竖,撇,点,横,竖,竖,横折,横
枰	横,竖,撇,点,横,点,撇,横,竖
枲	
枳	横,竖,撇,点,竖,横折,横,撇,点
枵	横,竖,撇,点,竖,横折,横,横,竖折折钩
架	横折钩,撇,竖,横折,横,横,竖,撇,捺
枷	横,竖,撇,点,横折钩,撇,竖,横折,横
枸	横,竖,撇,点,撇,横折钩,竖,横折,横
枹	
柁	横,竖,撇,点,点,点2,横撇|横钩,撇,竖弯钩
柃	横,竖,撇,点,撇,捺,点,横撇|横钩,点
柄	横,竖,撇,点,横,竖,横折钩,撇,点
柈	
柊	
柏	横,竖,撇,点,撇,竖,横折,横,横
某	横,竖,竖,横,横,横,竖,撇,捺
柑	横,竖,撇,点,横,竖,竖,横,横
柒	点,点,提,横,竖弯钩,横,竖,撇,捺
染	点,点,提,撇,横斜钩,横,竖,撇,捺
柔	横撇|横钩,点,横撇|横钩,竖钩,撇,横,竖,撇,捺
柖	
柘	横,竖,撇,点,横,撇,竖,横折,横
柙	横,竖,撇,点,竖,横折,横,横,竖
柚	横,竖,撇,点,竖,横折,横,竖,横
柜	横,竖,撇,点,横,横折,横,竖弯
柝	横,竖,撇,点,撇,撇,横,竖,点
柞	横,竖,撇,点,撇,横,竖,横,横
柠	横,竖,撇,点,点,点2,横撇|横钩,横,竖钩
柢	横,竖,撇,点,撇,竖提,横,斜钩|卧钩,点
查	横,竖,撇,捺,竖,横折,横,横,横
柩	横,竖,撇,点,横,撇,横撇|横钩,点,竖弯
柬	横,竖,横折,点,撇,横,竖,撇,捺
柯	横,竖,撇,点,横,竖,横折,横,竖钩
柰	横,竖,撇,捺,横,横,竖钩,撇,点
柱	横,竖,撇,点,点,横,横,竖,横
柳	横,竖,撇,点,撇,竖提,撇,横折钩,竖
柴	竖,横,竖,提,撇,竖弯钩,横,竖,撇,捺
柷	
柽	横,竖,撇,点,横撇|横钩,捺,横,竖,横
柿	横,竖,撇,点,点,横,竖,横折钩,竖
栀	横,竖,撇,点,撇,撇,横,横折钩,竖弯钩
栅	横,竖,撇,点,撇,横折钩,撇,横折钩,横
标	横,竖,撇,点,横,横,竖钩,撇,点
栈	横,竖,撇,点,横,横,斜钩|卧钩,撇,点
栉	横,竖,撇,点,横,竖,竖,横折钩,竖
栊	横,竖,撇,点,横,撇,竖弯钩,撇,点
栋	横,竖,撇,点,横,撇折,竖钩,撇,点
栌	横,竖,撇,点,竖,横,横折,横,撇
栎	横,竖,撇,点,撇,竖弯,竖钩,撇,点
栏	横,竖,撇,点,点,撇,横,横,横
栐	
树	横,竖,撇,点,横撇|横钩,点,横,竖钩,点
栒	
栓	横,竖,撇,点,撇,捺,横,横,竖,横
栖	横,竖,撇,点,横,竖,横折,撇,竖弯,横
栗	横,竖,横折,竖,竖,横,横,竖,撇,捺
栝	横,竖,撇,点,撇,横,竖,竖,横折,横
栟	
校	横,竖,撇,点,点,横,撇,点,撇,捺
栩	横,竖,撇,点,横折钩,点,提,横折钩,点,提
株	横,竖,撇,点,撇,横,横,竖,撇,捺
栲	横,竖,撇,点,横,竖,横,撇,横,竖折折钩
栳	横,竖,撇,点,横,竖,横,撇,撇,竖弯钩
栴	
样	横,竖,撇,点,点,撇,横,横,横,竖
核	横,竖,撇,点,点,横,撇折,撇,撇,点
根	横,竖,撇,点,横折,横,横,竖提,撇,捺
栻	
格	横,竖,撇,点,撇,横撇|横钩,捺,竖,横折,横
栽	横,竖,横,横,竖,撇,点,斜钩|卧钩,撇,点
栾	点,横,竖,竖,撇,点,横,竖,撇,捺
桀	撇,横撇|横钩,点,横,撇折,竖,横,竖,撇,捺
桁	横,竖,撇,点,撇,撇,竖,横,横,竖钩
桂	横,竖,撇,点,横,竖,横,横,竖,横
桃	横,竖,撇,点,撇,点,提,竖弯钩,撇,点
桄	横,竖,撇,点,竖,点,撇,横,撇,竖弯钩
桅	横,竖,撇,点,撇,横撇|横钩,横,撇,横折钩,竖弯钩
框	横,竖,撇,点,横,横,横,竖,横,竖弯
案	点,点2,横撇|横钩,撇点,撇,横,横,竖,撇,捺
桉	横,竖,撇,点,点,点2,横撇|横钩,撇点,撇,横
桊	点,撇,横,横,撇,捺,横,竖,撇,捺
桌	竖,横,竖,横折,横,横,横,竖,撇,捺
桎	横,竖,撇,点,横,撇折,点,横,竖,横
桐	横,竖,撇,点,竖,横折钩,横,竖,横折,横
桑	横撇|横钩,点,横撇|横钩,点,横撇|横钩,点,横,竖,撇,捺
桓	横,竖,撇,点,横,竖,横折,横,横,横
桔	横,竖,撇,点,横,竖,横,竖,横折,横
桕	横,竖,撇,点,撇,竖,横,横折,横,横
桠	横,竖,撇,点,横,竖,竖,点,撇,横
桡	横,竖,撇,点,横,斜钩|卧钩,撇,横,撇,竖弯钩
桢	横,竖,撇,点,竖,横,竖,横折,撇,点
档	横,竖,撇,点,竖,点,撇,横折,横,横
桤	横,竖,撇,点,竖,竖弯,竖,横折,横,竖弯钩
桥	横,竖,撇,点,撇,横,撇,捺,撇,竖
桦	横,竖,撇,点,撇,竖,撇,竖弯钩,横,竖
桧	横,竖,撇,点,撇,捺,横,横,撇折,点
桨	点,提,竖,撇,横撇|横钩,点,横,竖,撇,捺
桩	横,竖,撇,点,点,横,撇,横,竖,横
桫	横,竖,撇,点,点,点,提,竖,撇,点,撇
桯	
桲	
桴	横,竖,撇,点,撇,点,点,撇,横撇|横钩,竖钩,横
桶	横,竖,撇,点,横撇|横钩,点,竖,横折钩,横,横,竖
桷	横,竖,撇,点,撇,横撇|横钩,撇,横折钩,横,横,竖
桹	
梁	点,点,提,横折钩,撇,点2,点,横,竖,撇,捺
梃	横,竖,撇,点,撇,横,竖,横,横折折撇,捺
梅	横,竖,撇,点,撇,横,竖弯,横折钩,点,横,点
梆	横,竖,撇,点,横,横,横,撇,横折折折钩|横撇弯钩,竖
梌	
梏	横,竖,撇,点,撇,横,竖,横,竖,横折,横
梓	横,竖,撇,点,点,横,点,撇,横,横,竖
梗	横,竖,撇,点,横,竖,横折,横,横,撇,捺
梠	
梢	横,竖,撇,点,竖,点,撇,竖,横折钩,横,横
梣	
梦	横,竖,撇,点,横,竖,撇,捺,撇,横撇|横钩,点
梧	横,竖,撇,点,横,竖,横折,横,竖,横折,横
梨	撇,横,竖,撇,点,竖,竖钩,横,竖,撇,捺
梭	横,竖,撇,点,撇折,点,撇,点,撇,横撇|横钩,捺
梯	横,竖,撇,点,点,撇,横折,横,竖折折钩,竖,撇
械	横,竖,撇,点,横,横,撇,竖,斜钩|卧钩,撇,点
梳	横,竖,撇,点,点,横,撇折,点,撇,竖,竖弯钩
梴	
梵	横,竖,撇,点,横,竖,撇,捺,撇,横斜钩,点
梼	
梽	
梾	
梿	
检	横,竖,撇,点,撇,捺,横,点,点,撇,横
棁	
棂	横,竖,撇,点,横折,横,横,点2,撇,撇,捺
棉	横,竖,撇,点,撇,竖,横折,横,横,竖,横折钩,竖
棋	横,竖,撇,点,横,竖,竖,横,横,横,撇,点
棍	横,竖,撇,点,竖,横折,横,横,横,竖提,撇,竖弯钩
棐	
棒	横,竖,撇,点,横,横,横,撇,捺,横,横,竖
棓	
棕	横,竖,撇,点,点,点2,横撇|横钩,横,横,竖钩,撇,点
棘	横,竖,横折钩,竖,撇,点,横,竖,横折钩,竖,撇,捺
棚	横,竖,撇,点,撇,横折钩,横,横,撇,横折钩,横,横
棠	竖,点,撇,点2,横撇|横钩,竖,横折,横,横,竖,撇,捺
棣	横,竖,撇,点,横折,横,横,竖钩,点,提,撇,捺
棤	
棨	
棪	横,竖,撇,点,点2,撇,撇,点,点2,撇,撇,捺
棫	
棬	横,竖,撇,点,点,撇,横,横,撇,捺,横折钩,竖弯钩
森	横,竖,撇,捺,横,竖,撇,点,横,竖,撇,捺
棰	横,竖,撇,点,撇,横,竖,横,竖,竖,横,横
棱	横,竖,撇,点,横,竖,横,撇,点,撇,横撇|横钩,捺
棵	横,竖,撇,点,竖,横折,横,横,横,竖,撇,捺
棹	横,竖,撇,点,竖,横,竖,横折,横,横,横,竖
棺	横,竖,撇,点,点,点2,横撇|横钩,竖,横折,横,横折,横
棻	横,竖,竖,撇,点,横折钩,撇,横,竖,撇,捺
棼	横,竖,撇,点,横,竖,撇,点,撇,捺,横折钩,撇
棽	
椀	
椁	横,竖,撇,点,点,横,竖,横折,横,横撇|横钩,竖钩,横
椅	横,竖,撇,点,横,撇,点,横,竖,横折,横,竖钩
椆	
椋	横,竖,撇,点,点,横,竖,横折,横,竖钩,撇,点
植	横,竖,撇,点,横,竖,竖,横折,横,横,横,横
椎	横,竖,撇,点,撇,竖,点,横,横,横,竖,横
椐	横,竖,撇,点,横折,横,撇,横,竖,竖,横折,横
椑	
椒	横,竖,撇,点,竖,横,横,竖钩,撇,点,横撇|横钩,捺
椓	
椟	横,竖,撇,点,横,竖,横撇|横钩,点,点,横,撇,点
椠	横,撇折,竖,提,撇,撇,横,竖,横,竖,撇,捺
椤	横,竖,撇,点,竖,横折,竖,竖,横,撇,横撇|横钩,点
椪	横,竖,撇,点,点,撇,横,竖,竖,点,撇,横
椭	横,竖,撇,点,横折折折钩|横撇弯钩,竖,横,撇,竖,横折钩,横,横
椰	横,竖,撇,点,横,竖,竖,横,横,提,横折折折钩|横撇弯钩,竖
椴	横,竖,撇,点,撇,竖,横,横,提,撇,横折折|横折弯,横撇|横钩,捺
椸	
椹	横,竖,撇,点,横,竖,竖,横,横,横,撇,点,竖弯
椽	横,竖,撇,点,撇折,横撇|横钩,横,撇,弯钩,撇,撇,撇,捺
椿	横,竖,撇,点,横,横,横,撇,捺,竖,横折,横,横
楂	横,竖,撇,点,横,竖,撇,捺,竖,横折,横,横,横
楒	
楔	横,竖,撇,点,横,横,横,竖,横折钩,撇,横,撇,捺
楗	横,竖,撇,点,横折,横,横,横,横,竖,横折折撇,捺
楙	
楚	横,竖,撇,点,横,竖,撇,点,横撇|横钩,竖,横,撇,捺
楝	横,竖,撇,点,横,竖,横折,点,撇,横,竖,撇,捺
楞	横,竖,撇,点,竖,横折,竖,竖,横,点,横,横折钩,撇
楠	横,竖,撇,点,横,竖,竖,横折钩,点,撇,横,横,竖
楣	横,竖,撇,点,横折,竖,横,撇,竖,横折,横,横,横
楦	横,竖,撇,点,点,点2,横撇|横钩,横,竖,横折,横,横,横
楩	
楪	
楫	横,竖,撇,点,竖,横折,横,横,竖,竖,横,横,横
楮	横,竖,撇,点,横,竖,横,撇,竖,横折,横,横
楯	
楷	横,竖,撇,点,横,竖提,撇,竖弯钩,撇,竖,横折,横,横
楸	横,竖,撇,点,撇,横,竖,撇,点,点2,撇,撇,捺
楹	横,竖,撇,点,横折折折钩|横撇弯钩,撇,横撇|横钩,点,竖,横折,竖,竖,横
楼	横,竖,撇,点,点,撇,横,竖,撇,捺,撇点,撇,横
概	横,竖,撇,点,横折,横,横,竖提,点,横,撇折,撇,竖弯钩
榃	
榄	横,竖,撇,点,竖,竖,撇,横,点,竖,横折,撇,竖弯钩
榅	横,竖,撇,点,竖,横折,横,横,竖,横折,竖,竖,横
榆	横,竖,撇,点,撇,捺,横,竖,横折钩,横,横,竖,竖钩
榇	横,竖,撇,点,点,横,点,撇,横,横,竖钩,撇,点
榈	横,竖,撇,点,点,竖,横折钩,竖,横折,横,竖,横折,横
榉	横,竖,撇,点,点,点,撇,横,撇,捺,横,横,竖
榍	横,竖,撇,点,横折,横,撇,竖,点,撇,竖,横折钩,横,横
榑	
榔	横,竖,撇,点,点,横折,横,横,竖提,点,横折折折钩|横撇弯钩,竖
榕	横,竖,撇,点,点,点2,横撇|横钩,撇,点,撇,捺,竖,横折,横
榖	
榛	横,竖,撇,点,横,横,横,撇,捺,撇,横,竖,撇,点
榜	横,竖,撇,点,点,横,点,撇,点2,横撇|横钩,点,横,横折钩,撇
榧	横,竖,撇,点,横,竖,横,横,横,竖,横,横,横,竖弯
榨	横,竖,撇,点,点,点2,横撇|横钩,撇,点,撇,横,竖,横,横
榫	横,竖,撇,点,撇,竖,点,横,横,横,竖,横,横,竖
榭	横,竖,撇,点,撇,竖,横折钩,横,横,横,撇,横,竖钩,点
榰	
榱	横,竖,撇,点,点,横,竖,横折,横,横,撇,竖提,撇,捺
榴	横,竖,撇,点,撇,竖提,点,横折钩,撇,竖,横折,横,竖,横
榷	横,竖,撇,点,点2,横撇|横钩,撇,竖,点,横,横,横,竖,横
榻	横,竖,撇,点,竖,横折,横,横,横折钩,点,提,横折钩,点,提
槁	横,竖,撇,点,点,横,竖,横折,横,竖,横折钩,竖,横折,横
槃	撇,撇,横折钩,点,横,点,撇,横折折|横折弯,横撇|横钩,点,横,竖,撇,捺
槊	点,撇,横,竖弯,竖,撇,撇,横折钩,横,横,横,竖,撇,捺
槌	横,竖,撇,点,撇,竖,横折,横,横折,横,点,横折折撇,捺
槎	横,竖,撇,点,点,撇,横,横,横,撇,横,竖,横
槐	横,竖,撇,点,撇,竖,横折,横,横,撇,竖弯钩,撇折,点
槔	横,竖,撇,点,撇,竖,横折,横,横,横,撇,捺,横,竖
槚	
槛	横,竖,撇,点,竖,竖,撇,横,点,竖,横折,竖,竖,横
槜	
槟	横,竖,撇,点,点,点2,横撇|横钩,撇,竖,横,竖,横,撇,点
槠	横,竖,撇,点,点,横折提,横,竖,横,撇,竖,横折,横,横
槭	横,竖,撇,点,横,撇,竖,横,横,竖钩,撇,点,斜钩|卧钩,撇,点
槱	
槲	横,竖,撇,点,撇,横撇|横钩,撇,横折钩,横,横,竖,点,点,横,竖
槽	横,竖,撇,点,横,竖,横折,横,竖,竖,横,竖,横折,横,横
槿	横,竖,撇,点,横,竖,竖,横,竖,横折,横,横,横,竖,横
樊	横,竖,撇,点,撇,点,撇,点,横,竖,撇,点,横,撇,捺
樗	横,竖,撇,点,横,点2,横撇|横钩,竖,点,点,点,点,横,横,竖折折钩
樘	横,竖,撇,点,竖,点,撇,点2,横撇|横钩,竖,横折,横,横,竖,横
樟	横,竖,撇,点,点,横,点,撇,横,竖,横折,横,横,横,竖
模	横,竖,撇,点,横,竖,竖,竖,横折,横,横,横,撇,捺
樨	横,竖,撇,点,横折,横,撇,竖,点,提,撇,点,撇,横,横,竖
横	横,竖,撇,点,横,竖,竖,横,竖,横折,横,竖,横,撇,点
樯	横,竖,撇,点,横,竖,点,撇,横,竖,横折,竖,横折,横,横
樱	横,竖,撇,点,竖,横折,撇,点,竖,横折,撇,点,撇点,撇,横
樵	横,竖,撇,点,撇,竖,点,横,横,横,竖,横,点2,点,点,点
樽	横,竖,撇,点,点,撇,横,竖,横折,撇,竖弯,横,横,横,竖钩,点
樾	横,竖,撇,点,横,竖,横,竖,横,撇,捺,横,竖提,斜钩|卧钩,撇,点
橄	横,竖,撇,点,横撇|横钩,横,竖,竖,横,横,提,撇,横,撇,捺
橇	横,竖,撇,点,撇,横,横,竖弯钩,撇,横,横,竖提,撇,横,横,竖弯钩
橐	横,竖,横折,横,竖,点2,横撇|横钩,横,撇,竖,横折,横,横,竖,撇,捺
橑	
橘	横,竖,撇,点,横撇|横钩,点,横撇|横钩,竖钩,撇,竖,横折钩,撇,点,竖,横折,横
橙	横,竖,撇,点,横撇|横钩,点,撇,撇,捺,横,竖,横折,横,点,撇,横
橛	横,竖,撇,点,横,撇,点,撇,横,竖弯,竖,撇,撇,横撇|横钩,撇,捺
橞	
橡	横,竖,撇,点,撇,横撇|横钩,竖,横折,横,撇,弯钩,撇,撇,撇,捺
橥	撇,弯钩,撇,横,竖,横,撇,竖,横折,横,横,横,竖,撇,捺
橦	
橱	横,竖,撇,点,横,撇,横,竖,横折,横,点,撇,提,横,竖钩,点
橹	横,竖,撇,点,撇,横撇|横钩,竖,横折,横,竖,横,横,竖,横折,横,横
橼	横,竖,撇,点,撇折,撇折,提,撇折,横撇|横钩,横,撇,弯钩,撇,撇,撇,捺
檀	横,竖,撇,点,点,横,竖,横折,竖,横折,横,横,竖,横折,横,横,横
檄	横,竖,撇,点,撇,竖,横折,横,横,点,横,横折钩,撇,撇,横,撇,捺
檎	横,竖,撇,点,撇,捺,点,横,撇,点,竖弯,竖,竖,横折钩,撇折,点
檐	横,竖,撇,点,撇,横撇|横钩,横,撇,撇,点,点,横,横,横,竖,横折,横
檑	横,竖,撇,点,横,点2,横撇|横钩,竖,点,点,点,点,竖,横折,横,竖,横
檗	横折,横,撇,竖,横折,横,点,横,点,撇,横,横,竖,横,竖,撇,捺
檞	
檠	横,竖,竖,撇,横折钩,竖,横折,横,撇,横,撇,点,横,竖,撇,捺
檩	横,竖,撇,点,点,横,竖,横折,竖,横折,横,横,横,横,竖钩,撇,点
檫	横,竖,撇,点,点,点2,横撇|横钩,撇,横撇|横钩,点,点,横撇|横钩,捺,横,横,竖钩,撇,点
檬	横,竖,撇,点,横,竖,竖,点2,横撇|横钩,横,横,撇,弯钩,撇,撇,撇,捺
櫆	
欂	
欠	撇,横撇|横钩,撇,捺
次	点,提,撇,横撇|横钩,撇,捺
欢	横撇|横钩,点,撇,横撇|横钩,撇,捺
欣	撇,撇,横,竖,撇,横撇|横钩,撇,捺
欤	横,竖折折钩,提,撇,横撇|横钩,撇,捺
欧	横,撇,点,竖弯,撇,横撇|横钩,撇,捺
欲	撇,点,撇,点,竖,横折,横,撇,横撇|横钩,撇,捺
欸	
欹	横,撇,点,横,竖,横折,横,竖钩,撇,横撇|横钩,撇,捺
欺	横,竖,竖,横,横,横,撇,点,撇,横撇|横钩,撇,捺
欻	
款	横,竖,横,横,横,竖钩,撇,点,撇,横撇|横钩,撇,捺
歃	撇,横,竖,撇,竖,横,横折,横,横,撇,横撇|横钩,撇,捺
歅	
歆	点,横,点,撇,横,竖,横折,横,横,撇,横撇|横钩,撇,捺
歇	竖,横折,横,横,撇,横折钩,撇,点,竖弯,撇,横撇|横钩,撇,捺
歉	点,撇,横,横折,横,横,竖,竖,撇,点,撇,横撇|横钩,撇,捺
歌	横,竖,横折,横,竖,横,竖,横折,横,竖钩,撇,横撇|横钩,撇,捺
歙	撇,点,横,竖,横折,横,横折钩,点,提,横折钩,点,提,撇,横撇|横钩,撇,捺
止	竖,横,竖,横
正	横,竖,横,竖,横
此	竖,横,竖,提,撇,竖弯钩
步	竖,横,竖,横,竖,撇,撇
武	横,横,竖,横,竖,提,斜钩|卧钩,点
歧	竖,横,竖,提,横,竖,横撇|横钩,捺
歪	横,撇,竖,点,横,竖,横,竖,横
歹	横,撇,横撇|横钩,点
死	横,撇,横撇|横钩,点,撇,竖弯钩
歼	横,撇,横撇|横钩,点,撇,横,竖
殁	横,撇,横撇|横钩,点,撇,横折折|横折弯,横撇|横钩,捺
殂	横,撇,横撇|横钩,点,竖,横折,横,横,横
殃	横,撇,横撇|横钩,点,竖,横折,横,撇,捺
殄	横,撇,横撇|横钩,点,撇,捺,撇,撇,撇
殆	横,撇,横撇|横钩,点,撇折,点,竖,横折,横
殇	横,撇,横撇|横钩,点,撇,横,横折折折钩|横撇弯钩,撇,撇
殉	横,撇,横撇|横钩,点,撇,横折钩,竖,横折,横,横
殊	横,撇,横撇|横钩,点,撇,横,横,竖,撇,捺
残	横,撇,横撇|横钩,点,横,横,斜钩|卧钩,撇,点
殍	横,撇,横撇|横钩,点,撇,点,点,撇,横撇|横钩,竖钩,横
殒	横,撇,横撇|横钩,点,竖,横折,横,竖,横折,撇,点
殓	横,撇,横撇|横钩,点,撇,捺,横,点,点,撇,横
殖	横,撇,横撇|横钩,点,横,竖,竖,横折,横,横,横,横
殚	横,撇,横撇|横钩,点,点,撇,竖,横折,横,横,横,竖
殛	横,撇,横撇|横钩,点,横撇|横钩,竖钩,竖,横折,横,横撇|横钩,点,横
殡	横,撇,横撇|横钩,点,点,点2,横撇|横钩,撇,竖,横,竖,横,撇,点
殣	
殪	横,撇,横撇|横钩,点,横,竖,横,点2,横撇|横钩,横,竖,横折,横,点,撇,横
殳	撇,横折折|横折弯,横撇|横钩,捺
殴	横,撇,点,竖弯,撇,横折折|横折弯,横撇|横钩,捺
段	撇,竖,横,横,提,撇,横折折|横折弯,横撇|横钩,捺
殷	撇,撇,横折,横,横,横折钩,撇,横折折|横折弯,横撇|横钩,捺
殿	横折,横,撇,横,竖,竖,横,撇,点,撇,横折折|横折弯,横撇|横钩,捺
毁	撇,竖,横,横折,横,横,横,竖,提,撇,横折折|横折弯,横撇|横钩,捺
毂	横,竖,横,点2,横撇|横钩,横,撇折,竖,提,撇,横折折|横折弯,横撇|横钩,捺
毅	点,横,点,撇,横,撇,弯钩,撇,撇,撇,点,撇,横折折|横折弯,横撇|横钩,捺
毋	竖弯,横折钩,撇,横
毌	
母	竖弯,横折钩,点,横,点
每	撇,横,竖弯,横折钩,点,横,点
毐	
毒	横,横,竖,横,竖弯,横折钩,点,横,点
毓	撇,横,竖弯,横折钩,点,横,点,点,横,撇折,点,撇,竖,竖弯钩
比	横,竖提,撇,竖弯钩
毕	横,竖提,撇,竖弯钩,横,竖
毖	横,竖提,撇,竖弯钩,点2,斜钩|卧钩,点,撇,点
毗	竖,横折,横,竖,横,横,竖提,撇,竖弯钩
毙	横,竖提,撇,竖弯钩,横,撇,横撇|横钩,点,撇,竖弯钩
毛	撇,横,横,竖弯钩
毡	撇,横,横,竖弯钩,竖,横,竖,横折,横
毪	撇,横,横,竖弯钩,撇折,点,撇,横,横,竖
毫	点,横,竖,横折,横,点2,横撇|横钩,撇,横,横,竖弯钩
毯	撇,横,横,竖弯钩,点2,撇,撇,点,点2,撇,撇,点
毳	撇,横,横,竖弯钩,撇,横,横,竖提,撇,横,横,竖弯钩
毵	撇折,点,横,撇,点,撇,撇,撇,撇,横,横,竖弯钩
毹	撇,点,横,竖,横折钩,横,横,竖,竖钩,撇,横,横,竖弯钩
毽	撇,横,横,竖弯钩,横折,横,横,横,横,竖,横折折撇,捺
氅	竖,点,撇,竖,横折钩,竖,横折,横,撇,横,撇,捺,撇,横,横,竖弯钩
氆	撇,横,横,竖弯钩,点,撇,横,竖,竖,点,撇,横,竖,横折,横,横
氇	撇,横,横,竖弯钩,撇,横撇|横钩,竖,横折,横,竖,横,横,竖,横折,横,横
氍	竖,横折,横,横,横,竖,横折,横,横,横,撇,竖,点,横,横,横,竖,横,撇,横,横,竖弯钩
氏	撇,竖提,横,斜钩|卧钩
氐	撇,竖提,横,斜钩|卧钩,点
民	横折,横,竖提,横,斜钩|卧钩
氓	点,横,竖弯,横折,横,竖提,横,斜钩|卧钩
气	撇,横,横,横斜钩
氕	撇,横,横,横斜钩,撇
氖	撇,横,横,横斜钩,横折折折钩|横撇弯钩,撇
氘	撇,横,横,横斜钩,撇,竖
氙	撇,横,横,横斜钩,竖,竖弯,竖
氚	撇,横,横,横斜钩,撇,竖,竖
氛	撇,横,横,横斜钩,撇,捺,横折钩,撇
氟	撇,横,横,横斜钩,横折,横,竖折折钩,撇,竖
氡	撇,横,横,横斜钩,撇,横撇|横钩,捺,点,点
氢	撇,横,横,横斜钩,横撇|横钩,点,横,竖,横
氤	撇,横,横,横斜钩,竖,横折,横,撇,点,横
氦	撇,横,横,横斜钩,点,横,撇折,撇,撇,点
氧	撇,横,横,横斜钩,点,撇,横,横,横,竖
氨	撇,横,横,横斜钩,点,点2,横撇|横钩,撇点,撇,横
氩	撇,横,横,横斜钩,横,竖,竖,点,撇,横
氪	撇,横,横,横斜钩,横,竖,竖,横折,横,撇,竖弯钩
氮	撇,横,横,横斜钩,点2,撇,撇,点,点2,撇,撇,点
氯	撇,横,横,横斜钩,横折,横,横,竖钩,点,提,撇,点
氰	撇,横,横,横斜钩,横,横,竖,横,竖,横折钩,横,横
氲	撇,横,横,横斜钩,竖,横折,横,横,竖,横折,竖,竖,横
水	竖钩,横撇|横钩,撇,捺
永	点,横折钩,横撇|横钩,撇,捺
氾	点,点,提,横折钩,竖弯钩
氿	
汀	点,点,提,横,竖钩
汁	点,点,提,横,竖
求	横,竖钩,点,提,撇,捺,点
汆	撇,捺,竖钩,横撇|横钩,撇,捺
汇	点,点,提,横,竖弯
汈	
汉	点,点,提,横撇|横钩,捺
汊	点,点,提,横撇|横钩,捺,点
汋	
汐	点,点,提,撇,横撇|横钩,点
汔	点,点,提,撇,横,横斜钩
汕	点,点,提,竖,竖弯,竖
汗	点,点,提,横,横,竖
汛	点,点,提,横斜钩,横,竖
汜	点,点,提,横折,横,竖弯钩
汝	点,点,提,撇点,撇,横
汞	横,竖,横,竖钩,横撇|横钩,撇,捺
江	点,点,提,横,竖,横
池	点,点,提,横折钩,竖,竖弯钩
污	点,点,提,横,横,竖折折钩
汤	点,点,提,横折折折钩|横撇弯钩,撇,撇
汧	
汨	点,点,提,竖,横折,横,横
汩	点,点,提,竖,横折,横,横
汪	点,点,提,横,横,竖,横
汫	
汭	
汰	点,点,提,横,撇,捺,点
汲	点,点,提,撇,横折折撇,捺
汴	点,点,提,点,横,竖,点
汶	点,点,提,点,横,撇,捺
汹	点,点,提,撇,点,竖弯,竖
汽	点,点,提,撇,横,横,横斜钩
汾	点,点,提,撇,捺,横折钩,撇
沁	点,点,提,点2,斜钩|卧钩,点,点
沂	点,点,提,撇,撇,横,竖
沃	点,点,提,撇,横,撇,捺
沄	
沅	点,点,提,横,横,撇,竖弯钩
沆	点,点,提,点,横,撇,横斜钩
沇	
沈	点,点,提,点2,横撇|横钩,撇,竖弯钩
沉	点,点,提,点2,横撇|横钩,撇,横斜钩
沌	点,点,提,横,竖弯,竖,竖弯钩
沏	点,点,提,横,竖提,横折钩,撇
沐	点,点,提,横,竖,撇,捺
沓	竖钩,横撇|横钩,撇,捺,竖,横折,横,横
沔	点,点,提,横,竖,竖弯,横折钩
沘	
沙	点,点,提,竖,撇,点,撇
沚	
沛	点,点,提,横,竖,横折钩,竖
沟	点,点,提,撇,横折钩,撇折,点
没	点,点,提,撇,横折折|横折弯,横撇|横钩,捺
沣	点,点,提,横,横,横,竖
沤	点,点,提,横,撇,点,竖弯
沥	点,点,提,横,撇,横折钩,撇
沦	点,点,提,撇,捺,撇,竖弯钩
沧	点,点,提,撇,捺,横折钩,竖弯钩
沨	
沩	点,点,提,点,撇,横折钩,点
沪	点,点,提,点,横折,横,撇
沫	点,点,提,横,横,竖,撇,捺
沭	点,点,提,横,竖,撇,捺,点
沮	点,点,提,竖,横折,横,横,横
沱	点,点,提,点,点2,横撇|横钩,撇,竖弯钩
河	点,点,提,横,竖,横折,横,竖钩
沸	点,点,提,横折,横,竖折折钩,撇,竖
油	点,点,提,竖,横折,横,竖,横
沺	
治	点,点,提,撇折,点,竖,横折,横
沼	点,点,提,横折钩,撇,竖,横折,横
沽	点,点,提,横,竖,竖,横折,横
沾	点,点,提,竖,横,竖,横折,横
沿	点,点,提,撇,横折折|横折弯,竖,横折,横
泂	
泃	点,点,提,撇,横折钩,竖,横折,横
泄	点,点,提,横,竖,竖,横,竖弯
泅	点,点,提,竖,横折,撇,点,横
泇	
泉	撇,竖,横折,横,横,竖钩,横撇|横钩,撇,捺
泊	点,点,提,撇,竖,横折,横,横
泌	点,点,提,点2,斜钩|卧钩,点,撇,点
泐	点,点,提,横折折折钩|横撇弯钩,竖,横折钩,撇
泓	点,点,提,横折,横,竖折折钩,撇折,点
泔	点,点,提,横,竖,竖,横,横
法	点,点,提,横,竖,横,撇折,点
泖	点,点,提,撇,竖提,撇,横折钩,竖
泗	点,点,提,竖,横折,撇,竖弯,横
泙	
泚	
泛	点,点,提,撇,点,横撇|横钩,捺
泜	
泞	点,点,提,点,点2,横撇|横钩,横,竖钩
泠	点,点,提,撇,捺,点,横撇|横钩,点
泡	点,点,提,撇,横折钩,横折,横,竖弯钩
波	点,点,提,横撇|横钩,撇,竖,横撇|横钩,捺
泣	点,点,提,点,横,点,撇,横
泥	点,点,提,横折,横,撇,撇,竖弯钩
注	点,点,提,点,横,横,竖,横
泪	点,点,提,竖,横折,横,横,横
泫	点,点,提,点,横,撇折,撇折,点
泮	点,点,提,点,撇,横,横,竖
泯	点,点,提,横折,横,竖提,横,斜钩|卧钩
泰	横,横,横,撇,捺,竖钩,点,提,撇,点
泱	点,点,提,竖,横折,横,撇,捺
泳	点,点,提,点,横折钩,横撇|横钩,撇,捺
泵	横,撇,竖,横折,横,竖钩,横撇|横钩,撇,捺
泷	点,点,提,横,撇,竖弯钩,撇,点
泸	点,点,提,竖,横,横折,横,撇
泺	点,点,提,撇,竖弯,竖钩,撇,点
泻	点,点,提,点2,横撇|横钩,横,竖折折钩,横
泼	点,点,提,撇折,撇,横撇|横钩,捺,点
泽	点,点,提,横撇|横钩,捺,横,横,竖
泾	点,点,提,横撇|横钩,点,横,竖,横
洁	点,点,提,横,竖,横,竖,横折,横
洄	点,点,提,竖,横折,竖,横折,横,横
洇	点,点,提,竖,横折,横,撇,点,横
洈	
洋	点,点,提,点,撇,横,横,横,竖
洌	点,点,提,横,撇,横撇|横钩,点,竖,竖钩
洎	点,点,提,撇,竖,横折,横,横,横
洑	
洒	点,点,提,横,竖,横折,撇,竖弯,横
洓	
洗	点,点,提,撇,横,竖,横,撇,竖弯钩
洘	
洙	点,点,提,撇,横,横,竖,撇,捺
洚	点,点,提,撇,横撇|横钩,捺,横,撇折,竖
洛	点,点,提,撇,横撇|横钩,捺,竖,横折,横
洞	点,点,提,竖,横折钩,横,竖,横折,横
洢	
洣	
津	点,点,提,横折,横,横,横,横,竖
洧	点,点,提,横,撇,竖,横折钩,横,横
洨	
洪	点,点,提,横,竖,竖,横,撇,点
洫	点,点,提,撇,竖,横折,竖,竖,横
洭	
洮	点,点,提,撇,点,提,竖弯钩,撇,点
洱	点,点,提,横,竖,竖,横,横,横
洲	点,点,提,点2,撇,点,竖,点,竖
洳	点,点,提,撇点,撇,横,竖,横折,横
洴	
洵	点,点,提,撇,横折钩,竖,横折,横,横
洸	点,点,提,竖,点,撇,横,撇,竖弯钩
洹	点,点,提,横,竖,横折,横,横,横
洺	点,点,提,撇,横撇|横钩,点,竖,横折,横
活	点,点,提,撇,横,竖,竖,横折,横
洼	点,点,提,横,竖,横,横,竖,横
洽	点,点,提,撇,捺,横,竖,横折,横
派	点,点,提,撇,撇,撇,竖提,撇,捺
洿	
流	点,点,提,点,横,撇折,点,撇,竖,竖弯钩
浃	点,点,提,横,点,撇,横,撇,捺
浅	点,点,提,横,横,斜钩|卧钩,撇,点
浆	点,提,竖,撇,横撇|横钩,点,竖钩,横撇|横钩,撇,捺
浇	点,点,提,横,斜钩|卧钩,撇,横,撇,竖弯钩
浈	点,点,提,竖,横,竖,横折,撇,点
浉	
浊	点,点,提,竖,横折,横,竖,横,点
测	点,点,提,竖,横折,撇,点,竖,竖钩
浍	点,点,提,撇,捺,横,横,撇折,点
济	点,点,提,点,横,撇,捺,撇,竖
浏	点,点,提,点,横,撇,点,竖,竖钩
浐	点,点,提,点,横,点,撇,横,撇
浑	点,点,提,点2,横撇|横钩,横,撇折,横,竖
浒	点,点,提,点,横折提,撇,横,横,竖
浓	点,点,提,点2,横撇|横钩,撇,竖提,撇,捺
浔	点,点,提,横折,横,横,横,竖钩,点
浕	点,点,提,横折,横,撇,捺,点,点
浙	点,点,提,横,竖钩,提,撇,撇,横,竖
浚	点,点,提,撇折,点,撇,点,撇,横撇|横钩,捺
浛	
浜	点,点,提,撇,竖,横,竖,横,撇,点
浞	点,点,提,竖,横折,横,竖,横,撇,捺
浟	
浠	点,点,提,撇,点,横,撇,竖,横折钩,竖
浡	
浣	点,点,提,点,点2,横撇|横钩,横,横,撇,竖弯钩
浥	
浦	点,点,提,横,竖,横折钩,横,横,竖,点
浩	点,点,提,撇,横,竖,横,竖,横折,横
浪	点,点,提,点,横折,横,横,竖提,撇,捺
浬	
浭	
浮	点,点,提,撇,点,点,撇,横撇|横钩,竖钩,横
浯	点,点,提,横,竖,横折,横,竖,横折,横
浰	
浲	
浴	点,点,提,撇,点,撇,捺,竖,横折,横
海	点,点,提,撇,横,竖弯,横折钩,点,横,点
浸	点,点,提,横折,横,横,点2,横撇|横钩,横撇|横钩,捺
浼	点,点,提,撇,横撇|横钩,竖,横折,横,撇,竖弯钩
涂	点,点,提,撇,捺,横,横,竖钩,撇,点
涄	
涅	点,点,提,竖,横折,横,横,横,竖,横
消	点,点,提,竖,点,撇,竖,横折钩,横,横
涉	点,点,提,竖,横,竖,横,竖,撇,撇
涌	点,点,提,横撇|横钩,点,竖,横折钩,横,横,竖
涍	
涎	点,点,提,撇,竖,横,竖弯,横折折撇,捺
涐	
涑	点,点,提,横,竖,横折,横,竖,撇,捺
涓	点,点,提,竖,横折,横,竖,横折钩,横,横
涔	点,点,提,竖,竖弯,竖,撇,捺,点,横撇|横钩
涕	点,点,提,点,撇,横折,横,竖折折钩,竖,撇
涘	
涛	点,点,提,横,横,横,撇,横,竖钩,点
涝	点,点,提,横,竖,竖,点2,横撇|横钩,横折钩,撇
涞	点,点,提,横,点,撇,横,竖,撇,捺
涟	点,点,提,横,撇折,横,竖,点,横折折撇,捺
涠	点,点,提,竖,横折,横,横,横折钩,竖,横
涡	点,点,提,竖,横折,横,竖,横折钩,撇,点
涢	
涣	点,点,提,撇,横撇|横钩,竖,横折,横,撇,捺
涤	点,点,提,撇,横撇|横钩,捺,横,竖钩,撇,点
润	点,点,提,点,竖,横折钩,横,横,竖,横
涧	点,点,提,点,竖,横折钩,竖,横折,横,横
涨	点,点,提,横折,横,竖折折钩,撇,横,竖提,捺
涩	点,点,提,横折钩,撇,点2,竖,横,竖,横
涪	点,点,提,点,横,点,撇,横,竖,横折,横
涫	点,点,提,点,点2,横撇|横钩,竖,横折,横,横折,横
涮	点,点,提,横折,横,撇,竖,横折钩,竖,竖,竖钩
涯	点,点,提,横,撇,横,竖,横,横,竖,横
液	点,点,提,点,横,撇,竖,撇,横撇|横钩,点,捺
涴	
涵	点,点,提,横撇|横钩,竖钩,点,提,撇,点,竖弯,竖
涸	点,点,提,竖,横折,横,竖,竖,横折,横,横
涿	点,点,提,横,撇,弯钩,撇,撇,点,撇,捺
淀	点,点,提,点,点2,横撇|横钩,横,竖,横,撇,捺
淄	点,点,提,撇点,撇点,撇点,竖,横折,横,竖,横
淅	点,点,提,横,竖,撇,点,撇,撇,横,竖
淆	点,点,提,撇,点,横,撇,竖,横折钩,横,横
淇	点,点,提,横,竖,竖,横,横,横,撇,点
淋	点,点,提,横,竖,撇,点,横,竖,撇,捺
淌	点,点,提,竖,点,撇,竖,横折钩,竖,横折,横
淏	
淑	点,点,提,竖,横,横,竖钩,撇,点,横撇|横钩,捺
淖	点,点,提,竖,横,竖,横折,横,横,横,竖
淘	点,点,提,撇,横折钩,撇,横,横,竖,竖弯,竖
淙	点,点,提,点,点2,横撇|横钩,横,横,竖钩,撇,点
淜	
淝	点,点,提,撇,横折钩,横,横,横折,竖,横,竖弯钩
淞	点,点,提,横,竖,撇,点,撇,捺,撇折,点
淟	
淠	点,点,提,竖,横折,横,竖,横,横,撇,竖
淡	点,点,提,点2,撇,撇,点,点2,撇,撇,捺
淤	点,点,提,点,横,横折钩,撇,撇,捺,点,点
淦	点,点,提,撇,捺,横,横,竖,点,撇,横
淫	点,点,提,撇,点,点,撇,撇,横,竖,横
淬	点,点,提,点,横,撇,点,撇,点,横,竖
淮	点,点,提,撇,竖,点,横,横,横,竖,横
淯	
深	点,点,提,点2,横撇|横钩,撇,点,横,竖,撇,捺
淳	点,点,提,点,横,竖,横折,横,横撇|横钩,竖钩,横
淴	
混	点,点,提,竖,横折,横,横,横,竖提,撇,竖弯钩
淹	点,点,提,横,撇,捺,竖,横折,横,横,竖弯钩
添	点,点,提,横,横,撇,捺,竖钩,点2,点,点
淼	竖钩,横撇|横钩,撇,捺,竖钩,横撇|横钩,撇,点,竖钩,横撇|横钩,撇,捺
清	点,点,提,横,横,竖,横,竖,横折钩,横,横
渊	点,点,提,撇,点,撇,横,竖,撇,点,竖
渌	点,点,提,横折,横,横,竖钩,点,提,撇,捺
渍	点,点,提,横,横,竖,横,竖,横折,撇,点
渎	点,点,提,横,竖,横撇|横钩,点,点,横,撇,点
渐	点,点,提,横,撇折,竖,提,撇,撇,横,竖
渑	点,点,提,竖,横折,横,竖,横折,横,横,竖弯钩
渔	点,点,提,撇,横撇|横钩,竖,横折,横,竖,横,横
渗	点,点,提,撇折,点,横,撇,捺,撇,撇,撇
渚	点,点,提,横,竖,横,撇,竖,横折,横,横
渝	点,点,提,撇,捺,横,竖,横折钩,横,横,竖,竖钩
渟	
渠	点,点,提,横,横折,横,竖弯,横,竖,撇,捺
渡	点,点,提,点,横,撇,横,竖,竖,横,横撇|横钩,捺
渣	点,点,提,横,竖,撇,捺,竖,横折,横,横,横
渤	点,点,提,横,竖,点2,横撇|横钩,横撇|横钩,竖钩,提,横折钩,撇
渥	点,点,提,横折,横,撇,横,撇折,点,横,竖,横
温	点,点,提,竖,横折,横,横,竖,横折,竖,竖,横
渫	点,点,提,横,竖,竖,横,竖弯,横,竖,撇,捺
渭	点,点,提,竖,横折,横,竖,横,竖,横折钩,横,横
港	点,点,提,横,竖,竖,横,撇,捺,横折,横,竖弯钩
渰	
渲	点,点,提,点,点2,横撇|横钩,横,竖,横折,横,横,横
渴	点,点,提,竖,横折,横,横,撇,横折钩,撇,点,竖弯
游	点,点,提,点,横,横折钩,撇,撇,横,横撇|横钩,竖钩,横
渺	点,点,提,竖,横折,横,横,横,竖,撇,点,撇
渼	
湃	点,点,提,撇,横,横,撇,横,横,横,横,竖
湄	点,点,提,横折,竖,横,撇,竖,横折,横,横,横
湉	点,点,提,点2,点,竖,撇,横,竖,竖,横折,横
湍	点,点,提,竖,竖弯,竖,横,撇,竖,横折钩,竖,竖
湎	点,点,提,横,撇,竖,横折,竖,竖,横,横,横
湑	
湓	点,点,提,撇,捺,横折钩,撇,竖,横折,竖,竖,横
湔	点,点,提,点,撇,横,竖,横折钩,横,横,竖,竖钩
湖	点,点,提,横,竖,竖,横折,横,撇,横折钩,横,横
湘	点,点,提,横,竖,撇,点,竖,横折,横,横,横
湛	点,点,提,横,竖,竖,横,横,横,撇,点,竖弯
湜	
湝	
湟	点,点,提,撇,竖,横折,横,横,横,横,竖,横
湣	点,点,提,横折,横,竖提,横,斜钩|卧钩,竖,横折,横,横
湫	点,点,提,撇,横,竖,撇,点,点2,撇,撇,捺
湮	点,点,提,横,竖,横折,竖,竖,横,横,竖,横
湲	
湴	
湾	点,点,提,点,横,竖,竖,撇,点,横折,横,竖折折钩
湿	点,点,提,竖,横折,横,横,竖,竖,点,撇,横
溁	
溃	点,点,提,竖,横折,横,竖,横,竖,横折,撇,点
溅	点,点,提,竖,横折,撇,点,横,横,斜钩|卧钩,撇,点
溆	点,点,提,撇,点,横,横,竖钩,撇,点,横撇|横钩,捺
溇	
溉	点,点,提,横折,横,横,竖提,点,横,撇折,撇,竖弯钩
溍	
溏	点,点,提,点,横,撇,横折,横,横,竖,竖,横折,横
源	点,点,提,横,撇,撇,竖,横折,横,横,竖钩,撇,点
溘	点,点,提,横,竖,横,撇折,点,竖,横折,竖,竖,横
溚	
溜	点,点,提,撇,竖提,点,横折钩,撇,竖,横折,横,竖,横
溞	
溟	点,点,提,点2,横撇|横钩,竖,横折,横,横,点,横,撇,点
溠	
溢	点,点,提,点,撇,横,撇,点,竖,横折,竖,竖,横
溥	点,点,提,横,竖,横折,横,横,竖,点,横,竖钩,点
溦	
溧	点,点,提,横,竖,横折,竖,竖,横,横,竖,撇,捺
溪	点,点,提,撇,点,点,撇,撇折,撇折,点,横,撇,捺
溯	点,点,提,点,撇,横,竖弯,竖,撇,撇,横折钩,横,横
溱	点,点,提,横,横,横,撇,捺,撇,横,竖,撇,点
溲	点,点,提,撇,竖,横,横折,横,横,竖,横撇|横钩,捺
溴	点,点,提,撇,竖,横折,横,横,横,横,撇,捺,点
溵	
溶	点,点,提,点,点2,横撇|横钩,撇,点,撇,捺,竖,横折,横
溷	点,点,提,竖,横折,横,撇,弯钩,撇,撇,撇,点,横
溹	
溺	点,点,提,横折,横,竖折折钩,点,提,横折,横,竖折折钩,点,提
溻	点,点,提,竖,横折,横,横,横折钩,点,提,横折钩,点,提
溽	点,点,提,横,撇,横,横,竖提,撇,捺,横,竖钩,点
滁	点,点,提,横折折折钩|横撇弯钩,竖,撇,捺,横,横,竖钩,撇,点
滂	点,点,提,点,横,点,撇,点2,横撇|横钩,点,横,横折钩,撇
滃	
滆	
滇	点,点,提,横,竖,竖,横折,横,横,横,横,撇,点
滉	
滋	点,点,提,点,撇,横,撇折,撇折,点,撇折,撇折,点
滍	
滏	点,点,提,撇,点,撇,捺,横,横,竖,点,撇,横
滑	点,点,提,竖,横折,横折,点2,横撇|横钩,竖,横折钩,横,横
滓	点,点,提,点,点2,横撇|横钩,点,横,点,撇,横,横,竖
滔	点,点,提,撇,点,点,撇,撇,竖,横,横折,横,横
滕	撇,横折钩,横,横,点,撇,横,横,撇,捺,竖钩,点,提,撇,点
滗	点,点,提,撇,横,点,撇,横,点,撇,横,横,竖弯钩
滘	点,点,提,点2,横撇|横钩,撇,点,横,竖,横,竖,横折,横
滚	点,点,提,点,横,撇,点,撇折,点,撇,竖提,撇,捺
滞	点,点,提,横,竖,竖,竖,点2,横撇|横钩,竖,横折钩,竖
滟	点,点,提,横,横,横,竖,撇,横撇|横钩,横折,竖,横,竖弯钩
滠	点,点,提,横,竖,竖,横,横,横,横撇|横钩,点,横撇|横钩,捺
满	点,点,提,横,竖,竖,横,竖,横折钩,撇,点,撇,点
滢	点,点,提,横,竖,竖,点2,横撇|横钩,横,横,竖,横,点
滤	点,点,提,竖,横,横撇|横钩,撇,横,竖弯钩,点2,斜钩|卧钩,点,点
滥	点,点,提,竖,竖,撇,横,点,竖,横折,竖,竖,横
滦	点,点,提,点,横,竖,竖,撇,点,横,竖,撇,捺
滧	
滨	点,点,提,点,点2,横撇|横钩,撇,竖,横,竖,横,撇,点
滩	点,点,提,横撇|横钩,点,撇,竖,点,横,横,横,竖,横
滪	
滫	
滴	点,点,提,点,横,点,撇,竖,横折钩,横,竖,竖,横折,横
滹	点,点,提,竖,横,横撇|横钩,撇,横,竖弯钩,撇,点,撇,横,竖钩
漂	点,点,提,横,竖,横折,竖,竖,横,横,横,竖钩,撇,点
漆	点,点,提,横,竖,撇,点,撇,捺,竖钩,点,提,撇,点
漈	点,点,提,撇,横撇|横钩,点,点,横撇|横钩,捺,横,横,竖钩,撇,点
漉	点,点,提,点,横,撇,横折,竖,竖,横,横,竖提,撇,竖弯钩
漋	
漏	点,点,提,横折,横,撇,横,竖,横折钩,竖,点,点,点,点
漓	点,点,提,点,横,撇,点,竖弯,竖,竖,横折钩,撇折,点
演	点,点,提,点,点2,横撇|横钩,横,竖,横折,横,竖,横,撇,点
漕	点,点,提,横,竖,横折,横,竖,竖,横,竖,横折,横,横
漖	点,点,提,横,竖,横,撇,横撇|横钩,竖钩,提,撇,横,撇,捺
漠	点,点,提,横,竖,竖,竖,横折,横,横,横,撇,捺
漤	点,点,提,横,竖,撇,点,横,竖,撇,捺,撇点,撇,横
漦	
漩	点,点,提,点,横,横折钩,撇,撇,横,横撇|横钩,竖,横,撇,捺
漪	点,点,提,撇,弯钩,撇,横,撇,点,横,竖,横折,横,竖钩
漫	点,点,提,竖,横折,横,横,竖,横折,竖,竖,横,横撇|横钩,捺
漭	点,点,提,横,竖,竖,横,撇,捺,点,横,撇,竖
漯	点,点,提,竖,横折,横,竖,横,撇折,撇折,点,竖钩,撇,点
漱	点,点,提,横,竖,横折,横,竖,撇,点,撇,横撇|横钩,撇,捺
漳	点,点,提,点,横,点,撇,横,竖,横折,横,横,横,竖
漴	
漶	点,点,提,竖,横折,横,竖,横折,横,竖,点2,斜钩|卧钩,点,点
漷	点,点,提,点,横,竖,横折,横,横撇|横钩,竖钩,提,横折折折钩|横撇弯钩,竖
漹	
漻	
漼	
漾	点,点,提,点,撇,横,横,竖,横,点,横折钩,横撇|横钩,撇,捺
潆	点,点,提,横,竖,竖,点2,横撇|横钩,撇折,撇折,点,竖钩,撇,点
潇	点,点,提,横,竖,竖,横折,横,横,竖,撇,竖,撇,点
潋	点,点,提,撇,点,横,点,点,撇,提,撇,横,撇,捺
潍	点,点,提,撇折,撇折,提,撇,竖,点,横,横,横,竖,横
潏	
潖	
潘	点,点,提,撇,点,撇,横,竖,撇,捺,竖,横折,横,竖,横
潜	点,点,提,横,横,撇,点,横,横,撇,捺,竖,横折,横,横
潞	点,点,提,竖,横折,横,竖,横,竖,提,撇,横撇|横钩,捺,竖,横折,横
潟	点,点,提,撇,竖,横,横折,横,横,撇,横折钩,点2,点,点,点
潢	点,点,提,横,竖,竖,横,竖,横折,横,竖,横,撇,点
潦	点,点,提,横,撇,捺,点,撇,竖,横折,横,横,竖钩,撇,点
潩	
潭	点,点,提,横,竖,横折,竖,竖,横,竖,横折,横,横,横,竖
潮	点,点,提,横,竖,竖,横折,横,横,横,竖,撇,横折钩,横,横
潲	点,点,提,撇,横,竖,撇,点,竖,点,撇,竖,横折钩,横,横
潴	点,点,提,撇,弯钩,撇,横,竖,横,撇,竖,横折,横,横
潵	
潸	点,点,提,横,竖,撇,点,横,竖,撇,捺,竖,横折钩,横,横
潺	点,点,提,横折,横,撇,横撇|横钩,竖钩,横,横撇|横钩,竖钩,提,横撇|横钩,竖钩,横
潼	点,点,提,点,横,点,撇,横,竖,横折,横,横,竖,横,横
潽	
潾	
澂	点,点,提,竖,竖弯,竖,横,横,横,竖,横,撇,横,撇,捺
澄	点,点,提,横撇|横钩,点,撇,撇,捺,横,竖,横折,横,点,撇,横
澈	点,点,提,点,横,撇折,点,竖,横折钩,横,横,撇,横,撇,捺
澉	点,点,提,横撇|横钩,横,竖,竖,横,横,提,撇,横,撇,捺
澌	点,点,提,横,竖,竖,横,横,横,撇,点,撇,撇,横,竖
澍	点,点,提,横,竖,横,竖,横折,横,点,撇,提,横,竖钩,点
澎	点,点,提,横,竖,横,竖,横折,横,点,撇,提,撇,撇,撇
澛	
澜	点,点,提,点,竖,横折钩,横,竖,横折,点,撇,横,竖,撇,点
澡	点,点,提,竖,横折,横,竖,横折,横,竖,横折,横,横,竖,撇,捺
澥	
澧	点,点,提,竖,横折,横,竖,竖,横,横,竖,横折,横,点,撇,横
澪	
澭	
澳	点,点,提,撇,竖,横折,点,撇,横,竖,撇,点,横,撇,捺
澴	
澶	点,点,提,点,横,竖,横折,竖,横折,横,横,竖,横折,横,横,横
澹	点,点,提,撇,横撇|横钩,横,撇,撇,点,点,横,横,横,竖,横折,横
澼	
澽	
激	点,点,提,撇,竖,横折,横,横,点,横,横折钩,撇,撇,横,撇,捺
濂	点,点,提,点,横,撇,点,撇,横,横折,横,横,竖,竖,撇,捺
濉	点,点,提,竖,横折,横,横,横,撇,竖,点,横,横,横,竖,横
濋	
濑	点,点,提,横,竖,横折,横,竖,撇,点,撇,横撇|横钩,竖,横折,撇,点
濒	点,点,提,竖,横,竖,横,竖,撇,撇,横,撇,竖,横折,撇,点
濞	点,点,提,撇,竖,横折,横,横,横,竖,横折,横,竖,横,横,撇,竖
濠	点,点,提,点,横,竖,横折,横,点2,横撇|横钩,横,撇,弯钩,撇,撇,撇,捺
濡	点,点,提,横,点2,横撇|横钩,竖,点,点,点,点,横,撇,竖,横折钩,竖,竖
濩	
濮	点,点,提,撇,竖,竖,竖,点,撇,横,点,撇,横,横,横,撇,捺
濯	点,点,提,横折,点,提,横折,点,提,撇,竖,点,横,横,横,竖,横
瀌	
瀍	点,点,提,点,横,撇,竖,横折,横,横,竖,横,横,撇,点,横,竖,横
瀑	点,点,提,竖,横折,横,横,横,竖,竖,横,撇,捺,竖钩,点,提,撇,点
瀔	
瀚	点,点,提,横,竖,竖,横折,横,横,横,竖,撇,捺,横折钩,点,提,横折钩,点,提
瀛	点,点,提,点,横,竖弯,竖,横折,横,撇,横折钩,横,横,撇点,撇,横,撇,横斜钩,点
瀣	点,点,提,竖,横,撇,横撇|横钩,点,横撇|横钩,捺,竖,横,横,横,竖,横,横,横,横
瀱	
瀵	点,点,提,点,撇,横,竖,撇,捺,竖,横折,横,竖,横,横,竖,竖,横,撇,点
瀹	点,点,提,撇,捺,横,竖,横折,横,竖,横折,横,竖,横折,横,竖,横折钩,横,竖,竖
瀼	
灈	
灌	点,点,提,横,竖,竖,竖,横折,横,竖,横折,横,撇,竖,点,横,横,横,竖,横
灏	点,点,提,竖,横折,横,横,点,横,竖,横折,横,竖钩,撇,点,横,撇,竖,横折,撇,点
灞	点,点,提,横,点2,横撇|横钩,竖,点,点,点,点,横,竖,竖,横,竖,横折,横,横,竖,撇,横折钩,横,横
火	点2,撇,撇,捺
灭	横,点2,撇,撇,捺
灯	点2,撇,撇,点,横,竖钩
灰	横,撇,点2,撇,撇,捺
灵	横折,横,横,点2,撇,撇,捺
灶	点2,撇,撇,点,横,竖,横
灸	撇,横撇|横钩,点,点2,撇,撇,捺
灼	点2,撇,撇,点,撇,横折钩,点
灾	点,点2,横撇|横钩,点2,撇,撇,捺
灿	点2,撇,撇,点,竖,竖弯,竖
炀	点2,撇,撇,点,横折折折钩|横撇弯钩,撇,撇
炅	竖,横折,横,横,点2,撇,撇,捺
炆	
炉	点2,撇,撇,点,点,横折,横,撇
炊	点2,撇,撇,点,撇,横撇|横钩,撇,捺
炌	
炎	点2,撇,撇,点,点2,撇,撇,捺
炒	点2,撇,撇,点,竖,撇,点,撇
炔	点2,撇,撇,点,横折,横,撇,捺
炕	点2,撇,撇,点,点,横,撇,横斜钩
炖	点2,撇,撇,点,横,竖弯,竖,竖弯钩
炘	点2,撇,撇,点,撇,撇,横,竖
炙	撇,横撇|横钩,点,点,点2,撇,撇,捺
炜	点2,撇,撇,点,横,横,横折钩,竖
炝	点2,撇,撇,点,撇,捺,横折钩,竖弯钩
炟	
炣	
炫	点2,撇,撇,点,点,横,撇折,撇折,点
炬	点2,撇,撇,点,横,横折,横,竖弯
炭	竖,竖弯,竖,横,撇,点2,撇,撇,捺
炮	点2,撇,撇,点,撇,横折钩,横折,横,竖弯钩
炯	点2,撇,撇,点,竖,横折钩,竖,横折,横
炱	撇折,点,竖,横折,横,点2,撇,撇,捺
炳	点2,撇,撇,点,横,竖,横折钩,撇,点
炷	点2,撇,撇,点,点,横,横,竖,横
炸	点2,撇,撇,点,撇,横,竖,横,横
点	竖,横,竖,横折,横,点2,点,点,点
炻	点2,撇,撇,点,横,撇,竖,横折,横
炼	点2,撇,撇,点,横,撇折,横折钩,撇,点
炽	点2,撇,撇,点,竖,横折,横,点2,点
烀	点2,撇,撇,点,撇,点,撇,横,竖钩
烁	点2,撇,撇,点,撇,竖弯,竖钩,撇,点
烂	点2,撇,撇,点,点,撇,横,横,横
烃	点2,撇,撇,点,横撇|横钩,点,横,竖,横
烈	横,撇,横撇|横钩,点,竖,竖钩,点2,点,点,点
烊	点2,撇,撇,点,点,撇,横,横,横,竖
烔	
烘	点2,撇,撇,点,横,竖,竖,横,撇,点
烙	点2,撇,撇,点,撇,横撇|横钩,捺,竖,横折,横
烛	点2,撇,撇,点,竖,横折,横,竖,横,点
烜	点2,撇,撇,点,横,竖,横折,横,横,横
烝	
烟	点2,撇,撇,点,竖,横折,横,撇,点,横
烠	
烤	点2,撇,撇,点,横,竖,横,撇,横,竖折折钩
烦	点2,撇,撇,点,横,撇,竖,横折,撇,点
烧	点2,撇,撇,点,横,斜钩|卧钩,撇,横,撇,竖弯钩
烨	点2,撇,撇,点,撇,竖,撇,竖弯钩,横,竖
烩	点2,撇,撇,点,撇,捺,横,横,撇折,点
烫	点,点,提,横折折折钩|横撇弯钩,撇,撇,点2,撇,撇,捺
烬	点2,撇,撇,点,横折,横,撇,捺,点,点
热	横,竖钩,提,撇,横斜钩,点,点2,点,点,点
烯	点2,撇,撇,点,撇,点,横,撇,竖,横折钩,竖
烶	
烷	点2,撇,撇,点,点,点2,横撇|横钩,横,横,撇,竖弯钩
烹	点,横,竖,横折,横,横撇|横钩,竖钩,点2,点,点,点
烺	
烻	
烽	点2,撇,撇,点,撇,横撇|横钩,捺,横,横,横,竖
焆	
焉	横,竖,横,竖,横,横,竖折折钩,点2,点,点,点
焊	点2,撇,撇,点,竖,横折,横,横,横,横,竖
焌	
焐	点2,撇,撇,点,横,竖,横折,横,竖,横折,横
焓	点2,撇,撇,点,撇,捺,点,横撇|横钩,竖,横折,横
焕	点2,撇,撇,点,撇,横撇|横钩,竖,横折,横,撇,捺
焖	点2,撇,撇,点,点,竖,横折钩,点2,斜钩|卧钩,点,点
焗	点2,撇,撇,点,横折,横,撇,横折钩,竖,横折,横
焘	横,横,横,撇,横,竖钩,点,点2,点,点,点
焙	点2,撇,撇,点,点,横,点,撇,横,竖,横折,横
焚	横,竖,撇,点,横,竖,撇,点,点2,撇,撇,捺
焜	点2,撇,撇,点,竖,横折,横,横,横,竖提,撇,竖弯钩
焞	
焦	撇,竖,点,横,横,横,竖,横,点2,点,点,点
焯	点2,撇,撇,点,竖,横,竖,横折,横,横,横,竖
焰	点2,撇,撇,点,撇,横撇|横钩,撇,竖,横,横折,横,横
焱	点2,撇,撇,捺,点2,撇,撇,点,点2,撇,撇,捺
然	撇,横撇|横钩,点,点,横,撇,捺,点,点2,点,点,点
煁	
煃	
煅	点2,撇,撇,点,撇,竖,横,横,提,撇,横折折|横折弯,横撇|横钩,捺
煊	点2,撇,撇,点,点,点2,横撇|横钩,横,竖,横折,横,横,横
煋	
煌	点2,撇,撇,点,撇,竖,横折,横,横,横,横,竖,横
煎	点,撇,横,竖,横折钩,横,横,竖,竖钩,点2,点,点,点
煓	
煜	点2,撇,撇,点,竖,横折,横,横,点,横,点,撇,横
煞	撇,横撇|横钩,横折,横,横,撇,横,撇,捺,点2,点,点,点
煟	
煤	点2,撇,撇,点,横,竖,竖,横,横,横,竖,撇,捺
煦	竖,横折,横,横,撇,横折钩,竖,横折,横,点2,点,点,点
照	竖,横折,横,横,横折钩,撇,竖,横折,横,点2,点,点,点
煨	点2,撇,撇,点,竖,横折,横,竖,横,横,竖提,撇,捺
煮	横,竖,横,撇,竖,横折,横,横,点2,点,点,点
煲	撇,竖,竖,横折,横,横,竖,撇,点,点2,撇,撇,捺
煳	点2,撇,撇,点,横,竖,竖,横折,横,撇,横折钩,横,横
煴	
煸	点2,撇,撇,点,点,横折,横,撇,竖,横折钩,横,竖,竖
煺	点2,撇,撇,点,横折,横,横,竖提,撇,点,点,横折折撇,捺
煽	点2,撇,撇,点,点,横折,横,撇,横折钩,点,提,横折钩,点,提
熄	点2,撇,撇,点,撇,竖,横折,横,横,横,点2,斜钩|卧钩,点,点
熇	
熊	撇折,点,竖,横折钩,横,横,撇,竖弯钩,撇,竖弯钩,点2,点,点,点
熏	撇,横,竖,横折,点,撇,横,竖,横,横,点2,点,点,点
熔	点2,撇,撇,点,点,点2,横撇|横钩,撇,点,撇,捺,竖,横折,横
熘	点2,撇,撇,点,撇,竖提,点,横折钩,撇,竖,横折,横,竖,横
熙	横,竖,竖,横折,横,竖,竖弯,横折,横,竖弯钩,点2,点,点,点
熛	
熜	
熟	点,横,竖,横折,横,横撇|横钩,竖钩,提,撇,横斜钩,点,点2,点,点,点
熠	点2,撇,撇,点,横折,点,提,横折,点,提,撇,竖,横折,横,横
熥	
熨	横折,横,撇,横,横,竖钩,撇,点,横,竖钩,点,点2,撇,撇,捺
熬	横,横,竖,横,横折钩,撇,撇,横,撇,捺,点2,点,点,点
熵	点2,撇,撇,点,点,横,点,撇,竖,横折钩,撇,点,竖,横折,横
熹	横,竖,横,竖,横折,横,点,撇,横,竖,横折,横,点2,点,点,点
熻	
燃	点2,撇,撇,点,撇,横撇|横钩,点,点,横,撇,捺,点,点2,点,点,点
燊	点2,撇,撇,点,点2,撇,撇,点,点2,撇,撇,点,横,竖,撇,捺
燋	
燎	点2,撇,撇,点,横,撇,捺,点,撇,竖,横折,横,横,竖钩,撇,点
燏	
燔	点2,撇,撇,点,撇,点,撇,横,竖,撇,捺,竖,横折,横,竖,横
燕	横,竖,竖,横,竖,横折,横,竖,横,提,撇,竖弯钩,点2,点,点,点
燚	点2,撇,撇,点,点2,撇,撇,点,点2,撇,撇,点,点2,撇,撇,捺
燠	点2,撇,撇,点,撇,竖,横折,点,撇,横,竖,撇,点,横,撇,捺
燥	点2,撇,撇,点,竖,横折,横,竖,横折,横,竖,横折,横,横,竖,撇,捺
燧	点2,撇,撇,点,点,撇,横,撇,弯钩,撇,撇,撇,点,点,横折折撇,捺
燮	点,横,横,横,竖,横折,横,点2,撇,撇,点,点2,撇,撇,点,横撇|横钩,捺
燹	横,撇,弯钩,撇,撇,撇,点,横,撇,弯钩,撇,撇,撇,点,点2,撇,撇,捺
爆	点2,撇,撇,点,竖,横折,横,横,横,竖,竖,横,撇,捺,竖钩,点,提,撇,点
爇	
爔	
爚	
爝	点2,撇,撇,点,撇,点,点,撇,竖,横折,竖,竖,横,横折,横,横,竖提,点,横,竖钩,点
爟	
爨	撇,竖,横,横,竖,横折,横,竖,横折,横,横折,横,横,点2,横撇|横钩,横,竖,撇,点,横,竖,撇,点,横,撇,捺,点2,撇,撇,点
爪	撇,撇,竖,捺
爬	撇,撇,竖,捺,横折,竖,横,竖弯钩
爰	撇,点,点,撇,横,横,撇,横撇|横钩,捺
爱	撇,点,点,撇,点2,横撇|横钩,横,撇,横撇|横钩,捺
爵	撇,点,点,撇,竖,横折,竖,竖,横,横折,横,横,竖提,点,横,竖钩,点
父	撇,点,撇,捺
爷	撇,点,撇,捺,横折钩,竖
爸	撇,点,撇,捺,横折,竖,横,竖弯钩
爹	撇,点,撇,捺,撇,横撇|横钩,点,撇,横撇|横钩,点
爻	撇,点,撇,捺
爽	横,撇,点,撇,点,撇,点,撇,点,撇,捺
爿	竖弯,竖,横,撇
牁	
牂	
片	撇,竖,横,横折
版	撇,竖,横,横折,撇,撇,横撇|横钩,捺
牌	撇,竖,横,横折,撇,竖,横折,横,横,撇,横,竖
牍	撇,竖,横,横折,横,竖,横撇|横钩,点,点,横,撇,点
牒	撇,竖,横,横折,横,竖,竖,横,竖弯,横,竖,撇,捺
牖	撇,竖,横,横折,点,横折,横,撇,横,竖,横折钩,横,横,竖,点
牙	横,撇折,竖钩,撇
牚	
牛	撇,横,横,竖
牝	撇,横,竖,提,撇,竖弯钩
牟	撇折,点,撇,横,横,竖
牡	撇,横,竖,提,横,竖,横
牢	点,点2,横撇|横钩,撇,横,横,竖
牤	
牥	
牦	撇,横,竖,提,撇,横,横,竖弯钩
牧	撇,横,竖,提,撇,横,撇,捺
物	撇,横,竖,提,撇,横折钩,撇,撇
牮	撇,竖,横,斜钩|卧钩,点,撇,横,横,竖
牯	撇,横,竖,提,横,竖,竖,横折,横
牲	撇,横,竖,提,撇,横,横,竖,横
牵	横,撇,点,点2,横撇|横钩,撇,横,横,竖
特	撇,横,竖,提,横,竖,横,横,竖钩,点
牺	撇,横,竖,提,横,竖,横折,撇,竖弯,横
牻	
牾	撇,横,竖,提,横,竖,横折,横,竖,横折,横
牿	撇,横,竖,提,撇,横,竖,横,竖,横折,横
犀	横折,横,撇,竖,点,提,撇,点,撇,横,横,竖
犁	撇,横,竖,撇,点,竖,竖钩,撇,横,横,竖
犄	撇,横,竖,提,横,撇,点,横,竖,横折,横,竖钩
犇	撇,横,横,竖,撇,横,竖,提,撇,横,横,竖
犊	撇,横,竖,提,横,竖,横撇|横钩,点,点,横,撇,点
犋	撇,横,竖,提,竖,横折,横,横,横,横,撇,点
犍	撇,横,竖,提,横折,横,横,横,横,竖,横折折撇,捺
犏	撇,横,竖,提,点,横折,横,撇,竖,横折钩,横,竖,竖
犒	撇,横,竖,提,点,横,竖,横折,横,竖,横折钩,竖,横折,横
犟	横折,横,竖折折钩,竖,横折,横,竖,横折,横,竖,横,点,撇,横,横,竖
犨	
犬	横,撇,捺,点
犯	撇,弯钩,撇,横折钩,竖弯钩
犰	撇,弯钩,撇,撇,横斜钩
犴	撇,弯钩,撇,横,横,竖
状	点,提,竖,横,撇,捺,点
犷	撇,弯钩,撇,点,横,撇
犸	撇,弯钩,撇,横折,竖折折钩,横
犹	撇,弯钩,撇,横,撇,竖弯钩,点
狁	撇,弯钩,撇,撇折,点,撇,竖弯钩
狂	撇,弯钩,撇,横,横,竖,横
狃	撇,弯钩,撇,横折,竖,横,横
狄	撇,弯钩,撇,点2,撇,撇,捺
狈	撇,弯钩,撇,竖,横折,撇,点
狉	
狍	撇,弯钩,撇,撇,横折钩,横折,横,竖弯钩
狎	撇,弯钩,撇,竖,横折,横,横,竖
狐	撇,弯钩,撇,撇,撇,竖提,点,捺
狒	撇,弯钩,撇,横折,横,竖折折钩,撇,竖
狗	撇,弯钩,撇,撇,横折钩,竖,横折,横
狙	撇,弯钩,撇,竖,横折,横,横,横
狝	
狞	撇,弯钩,撇,点,点2,横撇|横钩,横,竖钩
狠	撇,弯钩,撇,横折,横,横,竖提,撇,捺
狡	撇,弯钩,撇,点,横,撇,点,撇,捺
狨	撇,弯钩,撇,横,横,撇,斜钩|卧钩,撇,点
狩	撇,弯钩,撇,点,点2,横撇|横钩,横,竖钩,点
独	撇,弯钩,撇,竖,横折,横,竖,横,点
狭	撇,弯钩,撇,横,点,撇,横,撇,捺
狮	撇,弯钩,撇,竖,撇,横,竖,横折钩,竖
狯	撇,弯钩,撇,撇,捺,横,横,撇折,点
狰	撇,弯钩,撇,撇,横撇|横钩,横折,横,横,竖钩
狱	撇,弯钩,撇,点,横折提,横,撇,捺,点
狲	撇,弯钩,撇,横撇|横钩,竖钩,提,竖钩,撇,点
狳	撇,弯钩,撇,撇,捺,横,横,竖钩,撇,点
狴	撇,弯钩,撇,横,竖提,撇,竖弯钩,横,竖,横
狷	撇,弯钩,撇,竖,横折,横,竖,横折钩,横,横
狸	撇,弯钩,撇,竖,横折,横,横,竖,横,横
狺	撇,弯钩,撇,点,横,横,横,竖,横折,横
狻	撇,弯钩,撇,撇折,点,撇,点,撇,横撇|横钩,捺
狼	撇,弯钩,撇,点,横折,横,横,竖提,撇,捺
猁	撇,弯钩,撇,撇,横,竖,撇,点,竖,竖钩
猃	撇,弯钩,撇,撇,捺,横,点,点,撇,横
猄	
猇	
猊	撇,弯钩,撇,撇,竖,横,横折,横,横,撇,竖弯钩
猎	撇,弯钩,撇,横,竖,竖,横,竖,横折,横,横
猕	撇,弯钩,撇,横折,横,竖折折钩,撇,横撇|横钩,竖钩,撇,点
猖	撇,弯钩,撇,竖,横折,横,横,竖,横折,横,横
猗	撇,弯钩,撇,横,撇,点,横,竖,横折,横,竖钩
猛	撇,弯钩,撇,横撇|横钩,竖钩,横,竖,横折,竖,竖,横
猜	撇,弯钩,撇,横,横,竖,横,竖,横折钩,横,横
猝	撇,弯钩,撇,点,横,撇,点,撇,点,横,竖
猞	撇,弯钩,撇,撇,捺,横,横,竖,竖,横折,横
猡	撇,弯钩,撇,竖,横折,竖,竖,横,撇,横撇|横钩,点
猢	撇,弯钩,撇,横,竖,竖,横折,横,撇,横折钩,横,横
猥	撇,弯钩,撇,竖,横折,横,竖,横,横,竖提,撇,捺
猩	撇,弯钩,撇,竖,横折,横,横,撇,横,横,竖,横
猪	撇,弯钩,撇,横,竖,横,撇,竖,横折,横,横
猫	撇,弯钩,撇,横,竖,竖,竖,横折,横,竖,横
猬	撇,弯钩,撇,竖,横折,横,竖,横,竖,横折钩,横,横
献	横,竖,竖,横折钩,点,撇,横,横,竖,横,撇,捺,点
猯	
猰	
猱	撇,弯钩,撇,横撇|横钩,点,横撇|横钩,竖钩,撇,横,竖,撇,捺
猴	撇,弯钩,撇,撇,竖,横折,横,撇,横,横,撇,捺
猷	点,撇,横,竖,横折,撇,竖弯,横,横,横,撇,捺,点
猹	撇,弯钩,撇,横,竖,撇,捺,竖,横折,横,横,横
猺	
猾	撇,弯钩,撇,竖,横折,横折,点2,横撇|横钩,竖,横折钩,横,横
猿	撇,弯钩,撇,横,竖,横,竖,横折,横,撇,竖提,撇,捺
獍	撇,弯钩,撇,点,横,点,撇,横,竖,横折,横,横,撇,竖弯钩
獐	撇,弯钩,撇,点,横,点,撇,横,竖,横折,横,横,横,竖
獒	横,横,竖,横,横折钩,撇,撇,横,撇,点,横,撇,捺,点
獗	撇,弯钩,撇,横,撇,点,撇,横,竖弯,竖,撇,撇,横撇|横钩,撇,捺
獠	撇,弯钩,撇,横,撇,捺,点,撇,竖,横折,横,横,竖钩,撇,点
獬	撇,弯钩,撇,撇,横撇|横钩,撇,横折钩,横,横,竖,横折钩,撇,撇,横,横,竖
獭	撇,弯钩,撇,横,竖,横折,横,竖,撇,点,撇,横撇|横钩,竖,横折,撇,点
獯	撇,弯钩,撇,撇,横,竖,横折,点,撇,横,竖,横,横,点2,点,点,点
獴	撇,弯钩,撇,横,竖,竖,点2,横撇|横钩,横,横,撇,弯钩,撇,撇,撇,捺
獾	撇,弯钩,撇,横,竖,竖,竖,横折,横,竖,横折,横,撇,竖,点,横,横,横,竖,横
玃	
玄	点,横,撇折,撇折,点
率	点,横,撇折,撇折,点,点,提,撇,点,横,竖
玉	横,横,竖,横,点
王	横,横,竖,横
玎	横,横,竖,提,横,竖钩
玑	横,横,竖,提,撇,横斜钩
玒	
玓	
玕	
玖	横,横,竖,提,撇,横撇|横钩,捺
玘	
玙	横,横,竖,提,横,竖折折钩,横
玚	
玛	横,横,竖,提,横折,竖折折钩,横
玞	
玟	横,横,竖,提,点,横,撇,捺
玠	
玡	
玢	横,横,竖,提,撇,捺,横折钩,撇
玤	
玥	横,横,竖,提,撇,横折钩,横,横
玦	
玩	横,横,竖,提,横,横,撇,竖弯钩
玫	横,横,竖,提,撇,横,撇,捺
玭	
玮	横,横,竖,提,横,横,横折钩,竖
环	横,横,竖,提,横,撇,竖,点
现	横,横,竖,提,竖,横折,撇,竖弯钩
玱	
玲	横,横,竖,提,撇,捺,点,横撇|横钩,点
玳	横,横,竖,提,撇,竖,横,斜钩|卧钩,点
玶	
玷	横,横,竖,提,竖,横,竖,横折,横
玹	横,横,竖,提,点,横,撇折,撇折,点
玺	撇,横撇|横钩,竖钩,撇,点,横,横,竖,横,点
玻	横,横,竖,提,横撇|横钩,撇,竖,横撇|横钩,捺
玼	
玿	
珀	横,横,竖,提,撇,竖,横折,横,横
珂	横,横,竖,提,横,竖,横折,横,竖钩
珅	横,横,竖,提,竖,横折,横,横,竖
珇	
珈	横,横,竖,提,横折钩,撇,竖,横折,横
珉	横,横,竖,提,横折,横,竖提,横,斜钩|卧钩
珊	横,横,竖,提,撇,横折钩,撇,横折钩,横
珋	
珌	
珍	横,横,竖,提,撇,捺,撇,撇,撇
珏	横,横,竖,提,横,横,竖,横,点
珐	横,横,竖,提,横,竖,横,撇折,点
珑	横,横,竖,提,横,撇,竖弯钩,撇,点
珒	
珕	
珖	
珙	横,横,竖,提,横,竖,竖,横,撇,点
珛	
珝	
珞	横,横,竖,提,撇,横撇|横钩,捺,竖,横折,横
珠	横,横,竖,提,撇,横,横,竖,撇,捺
珢	
珣	横,横,竖,提,撇,横折钩,竖,横折,横,横
珥	横,横,竖,提,横,竖,竖,横,横,横
珦	
珧	横,横,竖,提,撇,点,提,竖弯钩,撇,点
珩	横,横,竖,提,撇,撇,竖,横,横,竖钩
珪	横,横,竖,提,横,竖,横,横,竖,横
珫	
班	横,横,竖,提,点2,撇,横,横,竖,横
珰	
珲	横,横,竖,提,点2,横撇|横钩,横,撇折,横,竖
珵	横,横,竖,提,竖,横折,横,横,横,竖,横
珷	
珸	
珹	
珺	横,横,竖,提,横折,横,横,撇,竖,横折,横
珽	横,横,竖,提,撇,横,竖,横,横折折撇,捺
琀	
球	横,横,竖,提,横,竖钩,点,提,撇,捺,点
琄	
琅	横,横,竖,提,点,横折,横,横,竖提,撇,捺
理	横,横,竖,提,竖,横折,横,横,竖,横,横
琇	横,横,竖,提,撇,横,竖,撇,捺,横折折折钩|横撇弯钩,撇
琈	
琉	横,横,竖,提,点,横,撇折,点,撇,竖,竖弯钩
琊	横,横,竖,提,横,撇折,竖钩,撇,横折折折钩|横撇弯钩,竖
琎	横,横,竖,提,横,横,撇,竖,点,横折折撇,捺
琏	横,横,竖,提,横,撇折,横,竖,点,横折折撇,捺
琐	横,横,竖,提,竖,点,撇,竖,横折,撇,点
琔	
琚	横,横,竖,提,横折,横,撇,横,竖,竖,横折,横
琛	横,横,竖,提,点2,横撇|横钩,撇,点,横,竖,撇,捺
琟	
琡	
琢	横,横,竖,提,横,撇,弯钩,撇,撇,点,撇,捺
琤	
琥	横,横,竖,提,竖,横,横撇|横钩,撇,横,竖弯钩,撇,横斜钩
琦	横,横,竖,提,横,撇,点,横,竖,横折,横,竖钩
琨	横,横,竖,提,竖,横折,横,横,横,竖提,撇,竖弯钩
琪	横,横,竖,提,横,竖,竖,横,横,横,撇,点
琫	
琬	横,横,竖,提,点,点2,横撇|横钩,撇,横撇|横钩,点,横折钩,竖弯钩
琭	
琮	横,横,竖,提,点,点2,横撇|横钩,横,横,竖钩,撇,点
琯	横,横,竖,提,点,点2,横撇|横钩,竖,横折,横,横折,横
琰	横,横,竖,提,点2,撇,撇,点,点2,撇,撇,捺
琲	
琳	横,横,竖,提,横,竖,撇,点,横,竖,撇,捺
琴	横,横,竖,横,横,横,竖,横,撇,捺,点,横撇|横钩
琵	横,横,竖,横,横,横,竖,横,横,竖提,撇,竖弯钩
琶	横,横,竖,横,横,横,竖,横,横折,竖,横,竖弯钩
琼	横,横,竖,提,点,横,竖,横折,横,竖钩,撇,点
瑀	横,横,竖,提,撇,竖,横折,横,竖,横折钩,竖,提,点
瑁	横,横,竖,提,竖,横折,横,横,竖,横折,横,横,横
瑂	
瑃	
瑄	横,横,竖,提,点,点2,横撇|横钩,横,竖,横折,横,横,横
瑅	
瑆	
瑑	
瑓	
瑔	
瑕	横,横,竖,提,横折,横,竖,横,横,横折,横,横撇|横钩,捺
瑖	
瑗	横,横,竖,提,撇,点,点,撇,横,横,撇,横撇|横钩,捺
瑙	横,横,竖,提,撇点,撇点,撇点,撇,竖,横折,撇,点,横
瑚	横,横,竖,提,横,竖,竖,横折,横,撇,横折钩,横,横
瑛	横,横,竖,提,横,竖,竖,竖,横折,横,撇,捺
瑜	横,横,竖,提,撇,捺,横,竖,横折钩,横,横,竖,竖钩
瑝	
瑞	横,横,竖,提,竖,竖弯,竖,横,撇,竖,横折钩,竖,竖
瑟	横,横,竖,横,横,横,竖,横,点2,斜钩|卧钩,点,撇,点
瑢	
瑧	
瑨	
瑬	
瑭	横,横,竖,提,点,横,撇,横折,横,横,竖,竖,横折,横
瑰	横,横,竖,提,撇,竖,横折,横,横,撇,竖弯钩,撇折,点
瑱	
瑳	
瑶	横,横,竖,提,撇,点,点,撇,撇,横,横,竖,竖弯,竖
瑷	横,横,竖,提,撇,点,点,撇,点2,横撇|横钩,横,撇,横撇|横钩,捺
瑾	横,横,竖,提,横,竖,竖,横,竖,横折,横,横,横,竖,横
璀	横,横,竖,提,竖,竖弯,竖,撇,竖,点,横,横,横,竖,横
璁	横,横,竖,提,撇,竖,横折,撇,横撇|横钩,点,横,点2,斜钩|卧钩,点,点
璃	横,横,竖,提,点,横,撇,点,竖弯,竖,竖,横折钩,撇折,点
璆	
璇	横,横,竖,提,点,横,横折钩,撇,撇,横,横撇|横钩,竖,横,撇,捺
璈	
璋	横,横,竖,提,点,横,点,撇,横,竖,横折,横,横,横,竖
璎	横,横,竖,提,竖,横折,撇,点,竖,横折,撇,点,撇点,撇,横
璐	横,横,竖,提,竖,横折,横,竖,横,竖,提,撇,横撇|横钩,捺,竖,横折,横
璒	
璘	横,横,竖,提,点,撇,横,竖,撇,捺,撇,横撇|横钩,点,横,撇折,竖
璜	横,横,竖,提,横,竖,竖,横,竖,横折,横,竖,横,撇,点
璞	横,横,竖,提,竖,竖,点,撇,横,点,撇,横,横,横,撇,捺
璟	横,横,竖,提,竖,横折,横,横,点,横,竖,横折,横,竖钩,撇,点
璠	横,横,竖,提,撇,点,撇,横,竖,撇,捺,竖,横折,横,竖,横
璥	
璧	横折,横,撇,竖,横折,横,点,横,点,撇,横,横,竖,横,横,竖,横,点
璨	横,横,竖,提,竖,横,撇,横撇|横钩,点,横撇|横钩,点,点,撇,横,竖,撇,捺
璩	横,横,竖,提,竖,横,横撇|横钩,撇,横,竖弯钩,横,撇,弯钩,撇,撇,撇,捺
璪	
璬	
璮	
璱	
璲	
璺	撇,竖,横,横,竖,横折,横,竖,横折,横,横折,横,横,点2,横撇|横钩,横,横,竖,横,点
瓀	
瓒	横,横,竖,提,撇,横,竖,横,撇,竖提,撇,横,竖,横,撇,竖弯钩,竖,横折,撇,点
瓖	
瓘	
瓜	撇,撇,竖提,点,捺
瓞	撇,撇,竖提,点,捺,撇,横,横,撇,点
瓠	横,撇,捺,横,横,竖折折钩,撇,撇,竖提,点,捺
瓢	横,竖,横折,竖,竖,横,横,横,竖钩,撇,点,撇,撇,竖提,点,捺
瓣	点,横,点,撇,横,横,撇,撇,撇,竖提,点,捺,点,横,点,撇,横,横,竖
瓤	点,横,竖,横折,横,竖,横折,横,横,横,竖,竖,横,撇,竖提,撇,点,撇,撇,竖提,点,捺
瓦	横,竖提,横斜钩,点
瓮	撇,捺,撇折,点,横,竖提,横斜钩,点
瓯	横,撇,点,竖弯,横,竖提,横斜钩,点
瓴	撇,点,点,横撇|横钩,点,横,竖提,横斜钩,点
瓶	点,撇,横,横,撇,竖,横,竖提,横斜钩,点
瓷	点,提,撇,横撇|横钩,撇,捺,横,竖提,横斜钩,点
瓻	
瓿	点,横,点,撇,横,竖,横折,横,横,竖提,横斜钩,点
甄	横,竖,横折,竖,竖,横,横,竖,提,横,竖提,横斜钩,点
甍	横,竖,竖,竖,横折,竖,竖,横,点2,横撇|横钩,横,竖提,横斜钩,点
甏	横,竖,横,竖,横折,横,点,撇,提,撇,撇,撇,横,竖提,横斜钩,点
甑	点,撇,竖,横折,竖,点,撇,横,竖,横折,横,横,横,竖提,横斜钩,点
甓	横折,横,撇,竖,横折,横,点,横,点,撇,横,横,竖,横,竖提,横斜钩,点
甗	
甘	横,竖,竖,横,横
甚	横,竖,竖,横,横,横,撇,点,竖弯
甜	撇,横,竖,竖,横折,横,横,竖,竖,横,横
生	撇,横,横,竖,横
甡	
甥	撇,横,横,竖,提,竖,横折,横,竖,横,横折钩,撇
甦	横,竖,横折,横,横,撇,捺,撇,横,横,竖,横
用	撇,横折钩,横,横,竖
甩	撇,横折钩,横,横,竖弯钩
甪	撇,撇,横折钩,横,横,竖
甫	横,竖,横折钩,横,横,竖,点
甬	横撇|横钩,点,竖,横折钩,横,横,竖
甭	横,撇,竖,点,撇,横折钩,横,横,竖
甯	点,点2,横撇|横钩,点2,斜钩|卧钩,点,点,竖,横折钩,横,横,竖
田	竖,横折,横,竖,横
由	竖,横折,横,竖,横
甲	竖,横折,横,横,竖
申	竖,横折,横,横,竖
电	竖,横折,横,横,竖弯钩
男	竖,横折,横,竖,横,横折钩,撇
甸	撇,横折钩,竖,横折,横,竖,横
町	竖,横折,横,竖,横,横,竖钩
画	横,竖,横折,横,竖,横,竖弯,竖
甾	撇点,撇点,撇点,竖,横折,横,竖,横
畀	竖,横折,横,竖,横,横,撇,竖
畅	竖,横折,横,横,竖,横折折折钩|横撇弯钩,撇,撇
畈	竖,横折,横,竖,横,撇,撇,横撇|横钩,捺
畋	竖,横折,横,竖,横,撇,横,撇,捺
界	竖,横折,横,竖,横,撇,捺,撇,竖
畎	竖,横折,横,竖,横,横,撇,捺,点
畏	竖,横折,横,竖,横,横,竖提,撇,捺
畔	竖,横折,横,竖,横,点,撇,横,横,竖
畖	
留	撇,竖提,点,横折钩,撇,竖,横折,横,竖,横
畚	撇折,点,横,撇,捺,竖,横折,横,竖,横
畛	竖,横折,横,竖,横,撇,捺,撇,撇,撇
畜	点,横,撇折,撇折,点,竖,横折,横,竖,横
畤	
略	竖,横折,横,竖,横,撇,横撇|横钩,捺,竖,横折,横
畦	竖,横折,横,竖,横,横,竖,横,横,竖,横
番	撇,点,撇,横,竖,撇,捺,竖,横折,横,竖,横
畬	撇,捺,横,横,竖钩,撇,点,竖,横折,横,竖,横
畯	
畲	撇,捺,横,横,竖钩,撇,点,竖,横折,横,竖,横
畴	竖,横折,横,竖,横,横,横,横,撇,横,竖钩,点
畸	竖,横折,横,竖,横,横,撇,点,横,竖,横折,横,竖钩
畹	竖,横折,横,竖,横,点,点2,横撇|横钩,撇,横撇|横钩,点,横折钩,竖弯钩
畿	撇折,撇折,点,撇折,撇折,点,横,竖,横折,横,竖,横,斜钩|卧钩,撇,点
疁	
疃	竖,横折,横,竖,横,点,横,点,撇,横,竖,横折,横,横,竖,横,横
疆	横折,横,竖折折钩,横,竖,提,横,竖,横折,横,竖,横,横,竖,横折,横,竖,横,横
疍	横撇|横钩,竖,横,撇,捺,竖,横折,横,横,横
疏	横撇|横钩,竖,横,竖,提,点,横,撇折,点,撇,竖,竖弯钩
疐	
疑	撇,竖弯钩,撇,横,横,撇,点,横撇|横钩,点,横撇|横钩,竖,横,撇,捺
疔	点,横,撇,点,提,横,竖钩
疖	点,横,撇,点,提,横折钩,竖
疗	点,横,撇,点,提,横撇|横钩,竖钩
疙	点,横,撇,点,提,撇,横,横斜钩
疚	点,横,撇,点,提,撇,横撇|横钩,捺
疝	点,横,撇,点,提,竖,竖弯,竖
疟	点,横,撇,点,提,横,竖弯,横
疠	点,横,撇,点,提,横,横折钩,撇
疡	点,横,撇,点,提,横折折折钩|横撇弯钩,撇,撇
疢	
疣	点,横,撇,点,提,横,撇,竖弯钩,点
疤	点,横,撇,点,提,横折,竖,横,竖弯钩
疥	点,横,撇,点,提,撇,捺,撇,竖
疫	点,横,撇,点,提,撇,横折折|横折弯,横撇|横钩,捺
疬	点,横,撇,点,提,横,撇,横折钩,撇
疭	
疮	点,横,撇,点,提,撇,捺,横折钩,竖弯钩
疯	点,横,撇,点,提,撇,横斜钩,撇,点
疰	点,横,撇,点,提,点,横,横,竖,横
疱	点,横,撇,点,提,撇,横折钩,横折,横,竖弯钩
疲	点,横,撇,点,提,横撇|横钩,撇,竖,横撇|横钩,捺
疳	点,横,撇,点,提,横,竖,竖,横,横
疴	点,横,撇,点,提,横,竖,横折,横,竖钩
疵	点,横,撇,点,提,竖,横,竖,提,撇,竖弯钩
疸	点,横,撇,点,提,竖,横折,横,横,横
疹	点,横,撇,点,提,撇,捺,撇,撇,撇
疼	点,横,撇,点,提,撇,横撇|横钩,捺,点,点
疽	点,横,撇,点,提,竖,横折,横,横,横
疾	点,横,撇,点,提,撇,横,横,撇,捺
痂	点,横,撇,点,提,横折钩,撇,竖,横折,横
痃	点,横,撇,点,提,点,横,撇折,撇折,点
痄	点,横,撇,点,提,撇,横,竖,横,横
病	点,横,撇,点,提,横,竖,横折钩,撇,点
症	点,横,撇,点,提,横,竖,横,竖,横
痈	点,横,撇,点,提,撇,横折钩,横,横,竖
痉	点,横,撇,点,提,横撇|横钩,点,横,竖,横
痊	点,横,撇,点,提,撇,捺,横,横,竖,横
痍	点,横,撇,点,提,横,横折,横,竖折折钩,撇,捺
痒	点,横,撇,点,提,点,撇,横,横,横,竖
痓	
痔	点,横,撇,点,提,横,竖,横,横,竖钩,点
痕	点,横,撇,点,提,横折,横,横,竖提,撇,捺
痘	点,横,撇,点,提,横,竖,横折,横,点,撇,横
痛	点,横,撇,点,提,横撇|横钩,点,竖,横折钩,横,横,竖
痞	点,横,撇,点,提,横,撇,竖,点,竖,横折,横
痢	点,横,撇,点,提,撇,横,竖,撇,点,竖,竖钩
痣	点,横,撇,点,提,横,竖,横,点2,斜钩|卧钩,点,点
痤	点,横,撇,点,提,撇,点,撇,点,横,竖,横
痦	点,横,撇,点,提,横,竖,横折,横,竖,横折,横
痧	点,横,撇,点,提,点,点,提,竖,撇,点,撇
痨	点,横,撇,点,提,横,竖,竖,点2,横撇|横钩,横折钩,撇
痪	点,横,撇,点,提,撇,横撇|横钩,竖,横折,横,撇,捺
痫	点,横,撇,点,提,点,竖,横折钩,横,竖,撇,点
痰	点,横,撇,点,提,点2,撇,撇,点,点2,撇,撇,捺
痱	点,横,撇,点,提,竖,横,横,横,竖,横,横,横
痴	点,横,撇,点,提,撇,横,横,撇,点,竖,横折,横
痹	点,横,撇,点,提,竖,横折,横,竖,横,横,撇,竖
痼	点,横,撇,点,提,竖,横折,横,竖,竖,横折,横,横
痿	点,横,撇,点,提,撇,横,竖,撇,捺,撇点,撇,横
瘀	点,横,撇,点,提,点,横,横折钩,撇,撇,捺,点,点
瘁	点,横,撇,点,提,点,横,撇,点,撇,点,横,竖
瘃	点,横,撇,点,提,横,撇,弯钩,撇,撇,点,撇,捺
瘅	点,横,撇,点,提,点,撇,竖,横折,横,横,横,竖
瘆	
瘊	点,横,撇,点,提,撇,竖,横折,横,撇,横,横,撇,捺
瘌	点,横,撇,点,提,横,竖,横折,横,竖,撇,点,竖,竖钩
瘐	点,横,撇,点,提,撇,竖,横,横折,横,横,撇,捺
瘕	点,横,撇,点,提,横折,横,竖,横,横,横折,横,横撇|横钩,捺
瘗	点,横,撇,点,提,横,点,撇,横,撇,捺,横,竖,横
瘘	点,横,撇,点,提,点,撇,横,竖,撇,捺,撇点,撇,横
瘙	点,横,撇,点,提,横撇|横钩,捺,点,竖,横折,横,竖,横,点
瘛	点,横,撇,点,提,横,横,横,竖,横折钩,撇,点2,斜钩|卧钩,点,点
瘟	点,横,撇,点,提,竖,横折,横,横,竖,横折,竖,竖,横
瘠	点,横,撇,点,提,点,提,撇,点,撇,捺,竖,横折钩,横,横
瘢	点,横,撇,点,提,撇,撇,横折钩,点,横,点,撇,横折折|横折弯,横撇|横钩,捺
瘤	点,横,撇,点,提,撇,竖提,点,横折钩,撇,竖,横折,横,竖,横
瘥	点,横,撇,点,提,点,撇,横,横,横,撇,横,竖,横
瘦	点,横,撇,点,提,撇,竖,横,横折,横,横,竖,横撇|横钩,捺
瘩	点,横,撇,点,提,横,竖,竖,撇,捺,横,竖,横折,横
瘪	点,横,撇,点,提,撇,竖,横折,横,横,横,撇,捺,撇,竖弯钩
瘫	点,横,撇,点,提,横撇|横钩,点,撇,竖,点,横,横,横,竖,横
瘭	点,横,撇,点,提,横,竖,横折,竖,竖,横,横,横,竖钩,撇,点
瘰	点,横,撇,点,提,竖,横折,横,竖,横,撇折,撇折,点,竖钩,撇,点
瘳	点,横,撇,点,提,横折,点,提,横折,点,提,撇,捺,撇,撇,撇
瘴	点,横,撇,点,提,点,横,点,撇,横,竖,横折,横,横,横,竖
瘵	点,横,撇,点,提,撇,横撇|横钩,点,点,横撇|横钩,捺,横,横,竖钩,撇,点
瘸	点,横,撇,点,提,横折钩,撇,竖,横折,横,竖,横折钩,撇,点,撇,点
瘼	点,横,撇,点,提,横,竖,竖,竖,横折,横,横,横,撇,捺
瘾	点,横,撇,点,提,横折折折钩|横撇弯钩,竖,撇,横撇|横钩,横折,横,横,点2,斜钩|卧钩,点,点
瘿	点,横,撇,点,提,竖,横折,撇,点,竖,横折,撇,点,撇点,撇,横
癀	点,横,撇,点,提,横,竖,竖,横,竖,横折,横,竖,横,撇,点
癃	点,横,撇,点,提,横折折折钩|横撇弯钩,竖,撇,横撇|横钩,捺,横,撇,横,横,竖,横
癌	点,横,撇,点,提,竖,横折,横,竖,横折,横,竖,横折,横,竖,竖弯,竖
癍	点,横,撇,点,提,横,横,竖,提,点,横,撇,点,横,横,竖,横
癔	点,横,撇,点,提,点,横,点,撇,横,竖,横折,横,横,点2,斜钩|卧钩,点,点
癖	点,横,撇,点,提,横折,横,撇,竖,横折,横,点,横,点,撇,横,横,竖
癗	
癜	点,横,撇,点,提,横折,横,撇,横,竖,竖,横,撇,点,撇,横折折|横折弯,横撇|横钩,捺
癞	点,横,撇,点,提,横,竖,横折,横,竖,撇,点,撇,横撇|横钩,竖,横折,撇,点
癣	点,横,撇,点,提,撇,横撇|横钩,竖,横折,横,竖,横,提,点,撇,横,横,横,竖
癫	点,横,撇,点,提,横,竖,竖,横折,横,横,横,横,撇,点,横,撇,竖,横折,撇,点
癯	点,横,撇,点,提,竖,横折,横,横,横,竖,横折,横,横,横,撇,竖,点,横,横,横,竖,横
癸	横撇|横钩,点,撇,撇,捺,横,横,撇,点
登	横撇|横钩,点,撇,撇,捺,横,竖,横折,横,点,撇,横
白	撇,竖,横折,横,横
百	横,撇,竖,横折,横,横
癿	
皂	撇,竖,横折,横,横,横,竖弯钩
的	撇,竖,横折,横,横,撇,横折钩,点
皆	横,竖提,撇,竖弯钩,撇,竖,横折,横,横
皇	撇,竖,横折,横,横,横,横,竖,横
皈	撇,竖,横折,横,横,撇,撇,横撇|横钩,捺
皋	撇,竖,横折,横,横,横,撇,捺,横,竖
皎	撇,竖,横折,横,横,点,横,撇,点,撇,捺
皑	撇,竖,横折,横,横,竖,竖弯,竖,横折,横,竖弯钩
皓	撇,竖,横折,横,横,撇,横,竖,横,竖,横折,横
皕	
皖	撇,竖,横折,横,横,点,点2,横撇|横钩,横,横,撇,竖弯钩
皙	横,竖,撇,点,撇,撇,横,竖,竖,横折,横,横
皛	
皞	
皤	撇,竖,横折,横,横,撇,点,撇,横,竖,撇,捺,竖,横折,横,竖,横
皦	
皭	
皮	横撇|横钩,撇,竖,横撇|横钩,捺
皱	撇,横撇|横钩,横折,横,横,横撇|横钩,撇,竖,横撇|横钩,捺
皲	点2,横撇|横钩,横,撇折,竖,提,横撇|横钩,撇,竖,横撇|横钩,捺
皴	撇折,点,撇,点,撇,横撇|横钩,点,横撇|横钩,撇,竖,横撇|横钩,捺
皿	竖,横折,竖,竖,横
盂	横,横,竖钩,竖,横折,竖,竖,横
盅	竖,横折,横,竖,竖,横折,竖,竖,横
盆	撇,捺,横折钩,撇,竖,横折,竖,竖,横
盈	横折折折钩|横撇弯钩,撇,横撇|横钩,点,竖,横折,竖,竖,横
盉	
益	点,撇,横,撇,点,竖,横折,竖,竖,横
盍	横,竖,横,撇折,点,竖,横折,竖,竖,横
盎	竖,横折,横,撇,捺,竖,横折,竖,竖,横
盏	横,横,斜钩|卧钩,撇,点,竖,横折,竖,竖,横
盐	横,竖,提,竖,点,竖,横折,竖,竖,横
监	竖,竖,撇,横,点,竖,横折,竖,竖,横
盒	撇,捺,横,竖,横折,横,竖,横折,竖,竖,横
盔	横,撇,点2,撇,撇,捺,竖,横折,竖,竖,横
盖	点,撇,横,横,竖,横,竖,横折,竖,竖,横
盗	点,提,撇,横撇|横钩,撇,捺,竖,横折,竖,竖,横
盘	撇,撇,横折钩,点,横,点,竖,横折,竖,竖,横
盛	横,撇,横折钩,斜钩|卧钩,撇,点,竖,横折,竖,竖,横
盟	竖,横折,横,横,撇,横折钩,横,横,竖,横折,竖,竖,横
盥	撇,竖,横,横,竖钩,横撇|横钩,撇,点,横折,横,横,竖,横折,竖,竖,横
盦	
目	竖,横折,横,横,横
盯	竖,横折,横,横,横,横,竖钩
盱	竖,横折,横,横,横,横,横,竖钩
盲	点,横,竖弯,竖,横折,横,横,横
直	横,竖,竖,横折,横,横,横,横
盷	
相	横,竖,撇,点,竖,横折,横,横,横
盹	竖,横折,横,横,横,横,竖弯,竖,竖弯钩
盼	竖,横折,横,横,横,撇,捺,横折钩,撇
盾	撇,撇,横,竖,竖,横折,横,横,横
省	竖,撇,点,撇,竖,横折,横,横,横
眄	竖,横折,横,横,横,横,竖,竖弯,横折钩
眇	竖,横折,横,横,横,竖,撇,点,撇
眈	竖,横折,横,横,横,点2,横撇|横钩,撇,竖弯钩
眉	横折,竖,横,撇,竖,横折,横,横,横
眊	
看	撇,横,横,撇,竖,横折,横,横,横
眍	竖,横折,横,横,横,横,撇,点,竖弯
眙	竖,横折,横,横,横,撇折,点,竖,横折,横
眚	撇,横,横,竖,横,竖,横折,横,横,横
真	横,竖,竖,横折,横,横,横,横,撇,点
眠	竖,横折,横,横,横,横折,横,竖提,横,斜钩|卧钩
眢	撇,横撇|横钩,点,横折钩,竖弯钩,竖,横折,横,横,横
眦	竖,横折,横,横,横,竖,横,竖,提,撇,竖弯钩
眨	竖,横折,横,横,横,撇,点,横撇|横钩,捺
眩	竖,横折,横,横,横,点,横,撇折,撇折,点
眬	
眭	竖,横折,横,横,横,横,竖,横,横,竖,横
眯	竖,横折,横,横,横,点,撇,横,竖,撇,捺
眵	竖,横折,横,横,横,撇,横撇|横钩,点,撇,横撇|横钩,点
眶	竖,横折,横,横,横,横,横,横,竖,横,竖弯
眷	点,撇,横,横,撇,捺,竖,横折,横,横,横
眸	竖,横折,横,横,横,撇折,点,撇,横,横,竖
眺	竖,横折,横,横,横,撇,点,提,竖弯钩,撇,点
眼	竖,横折,横,横,横,横折,横,横,竖提,撇,捺
着	点,撇,横,横,横,撇,竖,横折,横,横,横
睁	竖,横折,横,横,横,撇,横撇|横钩,横折,横,横,竖钩
睃	竖,横折,横,横,横,撇折,点,撇,点,撇,横撇|横钩,捺
睄	
睇	竖,横折,横,横,横,点,撇,横折,横,竖折折钩,竖,撇
睎	
睐	竖,横折,横,横,横,横,点,撇,横,竖,撇,捺
睑	竖,横折,横,横,横,撇,捺,横,点,点,撇,横
睚	竖,横折,横,横,横,横,撇,横,竖,横,横,竖,横
睛	竖,横折,横,横,横,横,横,竖,横,竖,横折钩,横,横
睡	竖,横折,横,横,横,撇,横,竖,横,竖,竖,横,横
睢	竖,横折,横,横,横,撇,竖,点,横,横,横,竖,横
督	竖,横,横,竖,撇,点,横撇|横钩,捺,竖,横折,横,横,横
睥	竖,横折,横,横,横,撇,竖,横折,横,横,撇,横,竖
睦	竖,横折,横,横,横,横,竖,横,撇,点,横,竖,横
睨	竖,横折,横,横,横,撇,竖,横,横折,横,横,撇,竖弯钩
睫	竖,横折,横,横,横,横,横折,横,横,竖,横,撇,捺
睬	竖,横折,横,横,横,撇,点,点,撇,横,竖,撇,捺
睹	竖,横折,横,横,横,横,竖,横,撇,竖,横折,横,横
睽	竖,横折,横,横,横,横撇|横钩,点,撇,撇,捺,横,横,撇,点
睾	撇,竖,横折,竖,竖,横,横,竖,横,点,撇,横,横,竖
睿	竖,横,点2,横撇|横钩,横,撇,点,撇,捺,竖,横折,横,横,横
瞀	横撇|横钩,点,横撇|横钩,竖钩,撇,撇,横,撇,捺,竖,横折,横,横,横
瞄	竖,横折,横,横,横,横,竖,竖,竖,横折,横,竖,横
瞅	竖,横折,横,横,横,撇,横,竖,撇,点,点2,撇,撇,捺
瞋	
瞌	竖,横折,横,横,横,横,竖,横,撇折,点,竖,横折,竖,竖,横
瞍	竖,横折,横,横,横,撇,竖,横,横折,横,横,竖,横撇|横钩,捺
瞎	竖,横折,横,横,横,点,点2,横撇|横钩,横,横,横,竖,竖,横折,横
瞑	竖,横折,横,横,横,点2,横撇|横钩,竖,横折,横,横,点,横,撇,点
瞒	竖,横折,横,横,横,横,竖,竖,横,竖,横折钩,撇,点,撇,点
瞟	竖,横折,横,横,横,横,竖,横折,竖,竖,横,横,横,竖钩,撇,点
瞠	竖,横折,横,横,横,竖,点,撇,点2,横撇|横钩,竖,横折,横,横,竖,横
瞢	横,竖,竖,竖,横折,竖,竖,横,点2,横撇|横钩,竖,横折,横,横,横
瞥	点,撇,竖,横折钩,竖,撇,点,撇,横,撇,捺,竖,横折,横,横,横
瞧	竖,横折,横,横,横,撇,竖,点,横,横,横,竖,横,点2,点,点,点
瞩	竖,横折,横,横,横,横折,横,撇,撇,竖,横折,横,竖,横折钩,竖,提,点
瞪	竖,横折,横,横,横,横撇|横钩,点,撇,撇,捺,横,竖,横折,横,点,撇,横
瞫	
瞬	竖,横折,横,横,横,撇,点,点,撇,点2,横撇|横钩,撇,横撇|横钩,点,横,撇折,竖
瞭	竖,横折,横,横,横,横,撇,捺,点,撇,竖,横折,横,横,竖钩,撇,点
瞰	竖,横折,横,横,横,横撇|横钩,横,竖,竖,横,横,提,撇,横,撇,捺
瞳	竖,横折,横,横,横,点,横,点,撇,横,竖,横折,横,横,竖,横,横
瞵	竖,横折,横,横,横,点,撇,横,竖,撇,捺,撇,横撇|横钩,点,横,撇折,竖
瞻	竖,横折,横,横,横,撇,横撇|横钩,横,撇,撇,点,点,横,横,横,竖,横折,横
瞽	横,竖,横,竖,横折,横,点,撇,提,横,竖,横撇|横钩,捺,竖,横折,横,横,横
瞿	竖,横折,横,横,横,竖,横折,横,横,横,撇,竖,点,横,横,横,竖,横
矍	竖,横折,横,横,横,竖,横折,横,横,横,撇,竖,点,横,横,横,竖,横,横撇|横钩,捺
矗	横,竖,竖,横折,横,横,横,横,横,竖,竖,横折,横,横,横,提,横,竖,竖,横折,横,横,横,横
矛	横撇|横钩,点,横撇|横钩,竖钩,撇
矜	横撇|横钩,点,横撇|横钩,竖钩,撇,撇,捺,点,横撇|横钩
矞	
矢	撇,横,横,撇,捺
矣	撇折,点,撇,横,横,撇,捺
知	撇,横,横,撇,点,竖,横折,横
矧	撇,横,横,撇,点,横折,横,竖折折钩,竖
矩	撇,横,横,撇,点,横,横折,横,竖弯
矫	撇,横,横,撇,点,撇,横,撇,捺,撇,竖
矬	撇,横,横,撇,点,撇,点,撇,点,横,竖,横
短	撇,横,横,撇,点,横,竖,横折,横,点,撇,横
矮	撇,横,横,撇,点,撇,横,竖,撇,捺,撇点,撇,横
矰	
石	横,撇,竖,横折,横
矶	横,撇,竖,横折,横,撇,横斜钩
矸	横,撇,竖,横折,横,横,横,竖
矻	
矼	
矾	横,撇,竖,横折,横,撇,横斜钩,点
矿	横,撇,竖,横折,横,点,横,撇
砀	横,撇,竖,横折,横,横折折折钩|横撇弯钩,撇,撇
码	横,撇,竖,横折,横,横折,竖折折钩,横
砂	横,撇,竖,横折,横,竖,撇,点,撇
砄	
砆	
砉	横,横,横,竖,横,撇,竖,横折,横
砌	横,撇,竖,横折,横,横,竖提,横折钩,撇
砍	横,撇,竖,横折,横,撇,横撇|横钩,撇,捺
砑	横,撇,竖,横折,横,横,撇折,竖钩,撇
砒	横,撇,竖,横折,横,横,竖提,撇,竖弯钩
研	横,撇,竖,横折,横,横,横,撇,竖
砖	横,撇,竖,横折,横,横,横,竖折撇|竖折折,点
砗	横,撇,竖,横折,横,横,撇折,横,竖
砘	横,撇,竖,横折,横,横,竖弯,竖,竖弯钩
砚	横,撇,竖,横折,横,竖,横折,撇,竖弯钩
砜	横,撇,竖,横折,横,撇,横斜钩,撇,点
砝	横,撇,竖,横折,横,横,竖,横,撇折,点
砟	横,撇,竖,横折,横,撇,横,竖,横,横
砠	
砣	横,撇,竖,横折,横,点,点2,横撇|横钩,撇,竖弯钩
砥	横,撇,竖,横折,横,撇,竖提,横,斜钩|卧钩,点
砧	横,撇,竖,横折,横,竖,横,竖,横折,横
砫	
砬	横,撇,竖,横折,横,点,横,点,撇,横
砭	横,撇,竖,横折,横,撇,点,横撇|横钩,捺
砮	
砰	横,撇,竖,横折,横,横,点,撇,横,竖
破	横,撇,竖,横折,横,横撇|横钩,撇,竖,横撇|横钩,捺
砵	
砷	横,撇,竖,横折,横,竖,横折,横,横,竖
砸	横,撇,竖,横折,横,横,竖,横折钩,竖,竖弯
砹	横,撇,竖,横折,横,横,竖,竖,撇,捺
砺	横,撇,竖,横折,横,横,撇,横,横折钩,撇
砻	横,撇,竖弯钩,撇,点,横,撇,竖,横折,横
砼	横,撇,竖,横折,横,撇,捺,横,竖,横
砾	横,撇,竖,横折,横,撇,竖弯,竖钩,撇,点
础	横,撇,竖,横折,横,竖弯,竖,竖,竖弯,竖
硁	
硅	横,撇,竖,横折,横,横,竖,横,横,竖,横
硇	横,撇,竖,横折,横,撇,竖,横折,撇,点,横
硊	
硌	横,撇,竖,横折,横,撇,横撇|横钩,捺,竖,横折,横
硍	
硎	横,撇,竖,横折,横,横,横,撇,竖,竖,竖钩
硐	横,撇,竖,横折,横,竖,横折钩,横,竖,横折,横
硒	横,撇,竖,横折,横,横,竖,横折,撇,竖弯,横
硔	
硕	横,撇,竖,横折,横,横,撇,竖,横折,撇,点
硖	横,撇,竖,横折,横,横,点,撇,横,撇,捺
硗	横,撇,竖,横折,横,横,斜钩|卧钩,撇,横,撇,竖弯钩
硙	
硚	横,撇,竖,横折,横,撇,横,撇,捺,撇,竖
硝	横,撇,竖,横折,横,竖,点,撇,竖,横折钩,横,横
硪	横,撇,竖,横折,横,撇,横,竖钩,提,斜钩|卧钩,撇,点
硫	横,撇,竖,横折,横,点,横,撇折,点,撇,竖,竖弯钩
硬	横,撇,竖,横折,横,横,竖,横折,横,横,撇,捺
硭	横,撇,竖,横折,横,横,竖,竖,点,横,竖弯
确	横,撇,竖,横折,横,撇,横撇|横钩,撇,横折钩,横,横,竖
硼	横,撇,竖,横折,横,撇,横折钩,横,横,撇,横折钩,横,横
硿	
碃	
碇	横,撇,竖,横折,横,点,点2,横撇|横钩,横,竖,横,撇,捺
碈	
碉	横,撇,竖,横折,横,撇,横折钩,横,竖,横,竖,横折,横
碌	横,撇,竖,横折,横,横折,横,横,竖钩,点,提,撇,捺
碍	横,撇,竖,横折,横,竖,横折,横,横,横,横,竖钩,点
碎	横,撇,竖,横折,横,点,横,撇,点,撇,点,横,竖
碏	
碑	横,撇,竖,横折,横,撇,竖,横折,横,横,撇,横,竖
碓	横,撇,竖,横折,横,撇,竖,点,横,横,横,竖,横
碗	横,撇,竖,横折,横,点,点2,横撇|横钩,撇,横撇|横钩,点,横折钩,竖弯钩
碘	横,撇,竖,横折,横,竖,横折,横,竖,竖,横,撇,点
碚	横,撇,竖,横折,横,点,横,点,撇,横,竖,横折,横
碛	横,撇,竖,横折,横,横,横,竖,横,竖,横折,撇,点
碜	横,撇,竖,横折,横,撇折,点,横,撇,捺,撇,撇,撇
碟	横,撇,竖,横折,横,横,竖,竖,横,竖弯,横,竖,撇,捺
碡	横,撇,竖,横折,横,横,横,竖,横,竖弯,横折钩,点,横,点
碣	横,撇,竖,横折,横,竖,横折,横,横,撇,横折钩,撇,点,竖弯
碥	横,撇,竖,横折,横,点,横折,横,撇,竖,横折钩,横,竖,竖
碧	横,横,竖,提,撇,竖,横折,横,横,横,撇,竖,横折,横
碨	
碰	横,撇,竖,横折,横,点,撇,横,竖,竖,点,撇,横
碱	横,撇,竖,横折,横,横,撇,横,竖,横折,横,斜钩|卧钩,撇,点
碲	横,撇,竖,横折,横,点,横,点,撇,点2,横撇|横钩,竖,横折钩,竖
碳	横,撇,竖,横折,横,竖,竖弯,竖,横,撇,点2,撇,撇,捺
碴	横,撇,竖,横折,横,横,竖,撇,捺,竖,横折,横,横,横
碶	
碹	横,撇,竖,横折,横,点,点2,横撇|横钩,横,竖,横折,横,横,横
碾	横,撇,竖,横折,横,横折,横,撇,横,竖,竖,横,竖提,撇,捺
磁	横,撇,竖,横折,横,点,撇,横,撇折,撇折,点,撇折,撇折,点
磅	横,撇,竖,横折,横,点,横,点,撇,点2,横撇|横钩,点,横,横折钩,撇
磉	横,撇,竖,横折,横,横撇|横钩,点,横撇|横钩,点,横撇|横钩,点,横,竖,撇,捺
磊	横,撇,竖,横折,横,横,撇,竖,横折,横,横,撇,竖,横折,横
磋	横,撇,竖,横折,横,点,撇,横,横,横,撇,横,竖,横
磏	
磐	撇,撇,横折钩,点,横,点,撇,横折折|横折弯,横撇|横钩,捺,横,撇,竖,横折,横
磔	横,撇,竖,横折,横,撇,横撇|横钩,点,横,撇折,竖,横,竖,撇,捺
磕	横,撇,竖,横折,横,横,竖,横,撇折,点,竖,横折,竖,竖,横
磙	横,撇,竖,横折,横,点,横,撇,点,撇折,点,撇,竖提,撇,捺
磜	
磡	横,撇,竖,横折,横,横,竖,竖,横,横,横,撇,点,竖弯,横折钩,撇
磨	点,横,撇,横,竖,撇,点,横,竖,撇,捺,横,撇,竖,横折,横
磬	横,竖,横,横折,竖,横,撇,撇,横折折|横折弯,横撇|横钩,点,横,撇,竖,横折,横
磲	横,撇,竖,横折,横,点,点,提,横,横折,横,竖弯,横,竖,撇,捺
磴	横,撇,竖,横折,横,横撇|横钩,点,撇,撇,捺,横,竖,横折,横,点,撇,横
磷	横,撇,竖,横折,横,点,撇,横,竖,撇,捺,撇,横撇|横钩,点,横,撇折,竖
磹	
磻	
礁	横,撇,竖,横折,横,撇,竖,点,横,横,横,竖,横,点2,点,点,点
礅	横,撇,竖,横折,横,点,横,竖,横折,横,横撇|横钩,竖钩,提,撇,横,撇,捺
礌	
礓	横,撇,竖,横折,横,横,竖,横折,横,竖,横,横,竖,横折,横,竖,横,横
礞	横,撇,竖,横折,横,横,竖,竖,点2,横撇|横钩,横,横,撇,弯钩,撇,撇,撇,点
礴	横,撇,竖,横折,横,横,竖,竖,点,点,提,横,竖,横折,横,横,竖,点,横,竖钩,点
礵	
示	横,横,竖钩,撇,点
礼	点,横撇|横钩,竖,点,竖弯钩
社	点,横撇|横钩,竖,点,横,竖,横
祀	点,横撇|横钩,竖,点,横折,横,竖弯钩
祁	点,横撇|横钩,竖,点,横折折折钩|横撇弯钩,竖
祃	
祆	点,横撇|横钩,竖,点,横,横,撇,捺
祇	点,横撇|横钩,竖,点,撇,竖提,横,斜钩|卧钩
祈	点,横撇|横钩,竖,点,撇,撇,横,竖
祉	点,横撇|横钩,竖,点,竖,横,竖,横
祊	
祋	
祎	点,横撇|横钩,竖,点,横,横,横折钩,竖
祏	
祐	点,横撇|横钩,竖,点,横,撇,竖,横折,横
祓	点,横撇|横钩,竖,点,横,撇,横撇|横钩,捺,点
祕	点,横撇|横钩,竖,点,点2,斜钩|卧钩,点,撇,点
祖	点,横撇|横钩,竖,点,竖,横折,横,横,横
祗	点,横撇|横钩,竖,点,撇,竖提,横,斜钩|卧钩,点
祚	点,横撇|横钩,竖,点,撇,横,竖,横,横
祛	点,横撇|横钩,竖,点,横,竖,横,撇折,点
祜	点,横撇|横钩,竖,点,横,竖,竖,横折,横
祝	点,横撇|横钩,竖,点,竖,横折,横,撇,竖弯钩
神	点,横撇|横钩,竖,点,竖,横折,横,横,竖
祟	竖弯,竖,竖,竖弯,竖,横,横,竖钩,撇,点
祠	点,横撇|横钩,竖,点,横折钩,横,竖,横折,横
祢	点,横撇|横钩,竖,点,撇,横撇|横钩,竖钩,撇,点
祥	点,横撇|横钩,竖,点,点,撇,横,横,横,竖
祧	点,横撇|横钩,竖,点,撇,点,提,竖弯钩,撇,点
票	横,竖,横折,竖,竖,横,横,横,竖钩,撇,点
祭	撇,横撇|横钩,点,点,横撇|横钩,捺,横,横,竖钩,撇,点
祯	点,横撇|横钩,竖,点,竖,横,竖,横折,撇,点
祲	
祷	点,横撇|横钩,竖,点,横,横,横,撇,横,竖钩,点
祸	点,横撇|横钩,竖,点,竖,横折,横,竖,横折钩,撇,点
祺	点,横撇|横钩,竖,点,横,竖,竖,横,横,横,撇,点
祼	
祾	
禀	点,横,竖,横折,竖,横折,横,横,横,横,竖钩,撇,点
禁	横,竖,撇,点,横,竖,撇,捺,横,横,竖钩,撇,点
禄	点,横撇|横钩,竖,点,横折,横,横,竖钩,点,提,撇,捺
禅	点,横撇|横钩,竖,点,点,撇,竖,横折,横,横,横,竖
禊	点,横撇|横钩,竖,点,横,横,横,竖,横折钩,撇,横,撇,捺
禋	
福	点,横撇|横钩,竖,点,横,竖,横折,横,竖,横折,横,竖,横
禒	
禔	
禘	
禚	点,横撇|横钩,竖,点,点,撇,横,横,竖,横,点2,点,点,点
禛	
禤	点,横撇|横钩,竖,点,竖,横折,竖,竖,横,横折钩,点,提,横折钩,点,提
禧	点,横撇|横钩,竖,点,横,竖,横,竖,横折,横,点,撇,横,竖,横折,横
禳	点,横撇|横钩,竖,点,点,横,竖,横折,横,竖,横折,横,横,横,竖,竖,横,撇,竖提,撇,捺
禹	撇,竖,横折,横,竖,横折钩,竖,提,点
禺	竖,横折,横,横,竖,横折钩,竖,提,点
离	点,横,撇,点,竖弯,竖,竖,横折钩,撇折,点
禽	撇,捺,点,横,撇,点,竖弯,竖,竖,横折钩,撇折,点
禾	撇,横,竖,撇,捺
秀	撇,横,竖,撇,捺,横折折折钩|横撇弯钩,撇
私	撇,横,竖,撇,点,撇折,点
秃	撇,横,竖,撇,捺,撇,横斜钩
秆	撇,横,竖,撇,点,横,横,竖
秉	撇,横,横折,横,横,竖,撇,捺
秋	撇,横,竖,撇,点,点2,撇,撇,捺
种	撇,横,竖,撇,点,竖,横折,横,竖
科	撇,横,竖,撇,点,点,点,横,竖
秒	撇,横,竖,撇,点,竖,撇,点,撇
秕	撇,横,竖,撇,点,横,竖提,撇,竖弯钩
秘	撇,横,竖,撇,点,点2,斜钩|卧钩,点,撇,点
租	撇,横,竖,撇,点,竖,横折,横,横,横
秣	撇,横,竖,撇,点,横,横,竖,撇,捺
秤	撇,横,竖,撇,点,横,点,撇,横,竖
秦	横,横,横,撇,捺,撇,横,竖,撇,点
秧	撇,横,竖,撇,点,竖,横折,横,撇,捺
秩	撇,横,竖,撇,点,撇,横,横,撇,捺
秫	撇,横,竖,撇,点,横,竖,撇,捺,点
秬	
秭	撇,横,竖,撇,点,撇,竖折折钩,竖,撇
积	撇,横,竖,撇,点,竖,横折,横,撇,点
称	撇,横,竖,撇,点,撇,横撇|横钩,竖钩,撇,点
秸	撇,横,竖,撇,点,横,竖,横,竖,横折,横
移	撇,横,竖,撇,点,撇,横撇|横钩,点,撇,横撇|横钩,点
秽	撇,横,竖,撇,点,竖,竖弯,竖,撇,横撇|横钩,点
秾	
稀	撇,横,竖,撇,点,撇,点,横,撇,竖,横折钩,竖
稂	撇,横,竖,撇,点,点,横折,横,横,竖提,撇,捺
稃	撇,横,竖,撇,点,撇,点,点,撇,横撇|横钩,竖钩,横
稆	撇,横,竖,撇,点,竖,横折,横,竖,横折,横
程	撇,横,竖,撇,点,竖,横折,横,横,横,竖,横
稌	
稍	撇,横,竖,撇,点,竖,点,撇,竖,横折钩,横,横
税	撇,横,竖,撇,点,点,撇,竖,横折,横,撇,竖弯钩
稑	
稔	撇,横,竖,撇,点,撇,捺,点,横撇|横钩,点2,斜钩|卧钩,点,点
稗	撇,横,竖,撇,点,撇,竖,横折,横,横,撇,横,竖
稙	
稚	撇,横,竖,撇,点,撇,竖,点,横,横,横,竖,横
稞	撇,横,竖,撇,点,竖,横折,横,横,横,竖,撇,捺
稠	撇,横,竖,撇,点,撇,横折钩,横,竖,横,竖,横折,横
稣	撇,横撇|横钩,竖,横折,横,竖,横,提,撇,横,竖,撇,捺
稳	撇,横,竖,撇,点,撇,横撇|横钩,横折,横,横,点2,斜钩|卧钩,点,点
稷	撇,横,竖,撇,点,竖,横折,横,竖,横,撇,点,撇,横撇|横钩,捺
稹	撇,横,竖,撇,点,横,竖,竖,横折,横,横,横,横,撇,点
稻	撇,横,竖,撇,点,撇,点,点,撇,撇,竖,横,横折,横,横
稼	撇,横,竖,撇,点,点,点2,横撇|横钩,横,撇,弯钩,撇,撇,撇,捺
稽	撇,横,竖,撇,点,横,撇,竖弯钩,点,撇,竖弯钩,竖,横折,横,横
稿	撇,横,竖,撇,点,点,横,竖,横折,横,竖,横折钩,竖,横折,横
穄	
穆	撇,横,竖,撇,点,撇,竖,横折,横,横,竖,撇,点,撇,撇,撇
穑	撇,横,竖,撇,点,横,竖,点,撇,横,竖,横折,竖,横折,横,横
穗	撇,横,竖,撇,点,横,竖,横折,横,横,竖,横,点,点2,斜钩|卧钩,点,点
穙	
穜	
穟	
穰	撇,横,竖,撇,点,点,横,竖,横折,横,竖,横折,横,横,横,竖,竖,横,撇,竖提,撇,捺
穴	点,点2,横撇|横钩,撇,捺
究	点,点2,横撇|横钩,撇,点,撇,横斜钩
穷	点,点2,横撇|横钩,撇,点,横折钩,撇
穸	点,点2,横撇|横钩,撇,点,撇,横撇|横钩,点
穹	点,点2,横撇|横钩,撇,点,横折,横,竖折折钩
空	点,点2,横撇|横钩,撇,点,横,竖,横
穿	点,点2,横撇|横钩,撇,点,横,撇折,竖钩,撇
窀	点,点2,横撇|横钩,撇,点,横,竖弯,竖,竖弯钩
突	点,点2,横撇|横钩,撇,点,横,撇,捺,点
窃	点,点2,横撇|横钩,撇,点,横,竖提,横折钩,撇
窄	点,点2,横撇|横钩,撇,点,撇,横,竖,横,横
窅	
窈	点,点2,横撇|横钩,撇,点,撇折,撇折,点,横折钩,撇
窊	
窍	点,点2,横撇|横钩,撇,点,横,竖,提,横,竖折折钩
窎	
窑	点,点2,横撇|横钩,撇,点,撇,横,横,竖,竖弯,竖
窒	点,点2,横撇|横钩,撇,点,横,撇折,点,横,竖,横
窕	点,点2,横撇|横钩,撇,点,撇,点,提,竖弯钩,撇,点
窖	点,点2,横撇|横钩,撇,点,撇,横,竖,横,竖,横折,横
窗	点,点2,横撇|横钩,撇,点,撇,竖,横折,撇,横撇|横钩,点,横
窘	点,点2,横撇|横钩,撇,点,横折,横,横,撇,竖,横折,横
窜	点,点2,横撇|横钩,撇,点,竖,横折,横,竖,横折,横,竖
窝	点,点2,横撇|横钩,撇,点,竖,横折,横,竖,横折钩,撇,点
窟	点,点2,横撇|横钩,撇,点,横折,横,撇,竖弯,竖,竖,竖弯,竖
窠	点,点2,横撇|横钩,撇,点,竖,横折,横,横,横,竖,撇,捺
窣	点,点2,横撇|横钩,撇,点,点,横,撇,点,撇,点,横,竖
窥	点,点2,横撇|横钩,撇,点,横,横,撇,点,竖,横折,撇,竖弯钩
窦	点,点2,横撇|横钩,撇,点,横,竖,横撇|横钩,点,点,横,撇,点
窨	点,点2,横撇|横钩,撇,点,点,横,点,撇,横,竖,横折,横,横
窬	点,点2,横撇|横钩,撇,点,撇,捺,横,竖,横折钩,横,横,竖,竖钩
窭	点,点2,横撇|横钩,撇,点,点,撇,横,竖,撇,捺,撇点,撇,横
窳	点,点2,横撇|横钩,撇,点,撇,撇,竖提,点,点,撇,撇,竖提,点,捺
窸	点,点2,横撇|横钩,撇,点,撇,点,撇,横,竖,撇,捺,点2,斜钩|卧钩,点,点
窿	点,点2,横撇|横钩,撇,点,横折折折钩|横撇弯钩,竖,撇,横撇|横钩,捺,横,撇,横,横,竖,横
立	点,横,点,撇,横
竑	点,横,点,撇,提,横,撇,撇折,点
竖	竖,竖,横撇|横钩,捺,点,横,点,撇,横
竘	
站	点,横,点,撇,提,竖,横,竖,横折,横
竞	点,横,点,撇,横,竖,横折,横,撇,竖弯钩
竟	点,横,点,撇,横,竖,横折,横,横,撇,竖弯钩
章	点,横,点,撇,横,竖,横折,横,横,横,竖
竣	点,横,点,撇,提,撇折,点,撇,点,撇,横撇|横钩,捺
童	点,横,点,撇,横,竖,横折,横,横,竖,横,横
竦	点,横,点,撇,提,横,竖,横折,横,竖,撇,捺
竫	
竭	点,横,点,撇,提,竖,横折,横,横,撇,横折钩,撇,点,竖弯
端	点,横,点,撇,提,竖,竖弯,竖,横,撇,竖,横折钩,竖,竖
竹	撇,横,竖,撇,横,竖钩
竺	撇,横,点,撇,横,点,横,横
竽	撇,横,点,撇,横,点,横,横,竖钩
竿	撇,横,点,撇,横,点,横,横,竖
笃	撇,横,点,撇,横,点,横折,竖折折钩,横
笄	撇,横,点,撇,横,点,横,横,撇,竖
笆	撇,横,点,撇,横,点,横折,竖,横,竖弯钩
笈	撇,横,点,撇,横,点,撇,横折折撇,捺
笊	撇,横,点,撇,横,点,撇,撇,竖,捺
笋	撇,横,点,撇,横,点,横折,横,横,撇
笏	撇,横,点,撇,横,点,撇,横折钩,撇,撇
笑	撇,横,点,撇,横,点,撇,横,撇,捺
笔	撇,横,点,撇,横,点,撇,横,横,竖弯钩
笕	撇,横,点,撇,横,点,竖,横折,撇,竖弯钩
笙	撇,横,点,撇,横,点,撇,横,横,竖,横
笛	撇,横,点,撇,横,点,竖,横折,横,竖,横
笞	撇,横,点,撇,横,点,撇折,点,竖,横折,横
笠	撇,横,点,撇,横,点,点,横,点,撇,横
笤	撇,横,点,撇,横,点,横折钩,撇,竖,横折,横
笥	撇,横,点,撇,横,点,横折钩,横,竖,横折,横
符	撇,横,点,撇,横,点,撇,竖,横,竖钩,点
笨	撇,横,点,撇,横,点,横,竖,撇,捺,横
笪	撇,横,点,撇,横,点,竖,横折,横,横,横
笫	撇,横,点,撇,横,点,撇,竖折折钩,竖,撇
第	撇,横,点,撇,横,点,横折,横,竖折折钩,竖,撇
笮	撇,横,点,撇,横,点,撇,横,竖,横,横
笯	
笱	撇,横,点,撇,横,点,撇,横折钩,竖,横折,横
笳	撇,横,点,撇,横,点,横折钩,撇,竖,横折,横
笸	撇,横,点,撇,横,点,横,竖,横折,横,竖弯
笺	撇,横,点,撇,横,点,横,横,斜钩|卧钩,撇,点
笼	撇,横,点,撇,横,点,横,撇,竖弯钩,撇,点
笾	撇,横,点,撇,横,点,横折钩,撇,点,横折折撇,捺
筀	
筅	撇,横,点,撇,横,点,撇,横,竖,横,撇,竖弯钩
筇	撇,横,点,撇,横,点,横,竖,提,横折折折钩|横撇弯钩,竖
等	撇,横,点,撇,横,点,横,竖,横,横,竖钩,点
筋	撇,横,点,撇,横,点,撇,横折钩,横,横,横折钩,撇
筌	撇,横,点,撇,横,点,撇,捺,横,横,竖,横
筏	撇,横,点,撇,横,点,撇,竖,横,斜钩|卧钩,撇,点
筐	撇,横,点,撇,横,点,横,横,横,竖,横,竖弯
筑	撇,横,点,撇,横,点,横,竖,提,撇,横斜钩,点
筒	撇,横,点,撇,横,点,竖,横折钩,横,竖,横折,横
答	撇,横,点,撇,横,点,撇,捺,横,竖,横折,横
策	撇,横,点,撇,横,点,横,竖,横折钩,竖,撇,捺
筘	撇,横,点,撇,横,点,横,竖钩,提,竖,横折,横
筚	撇,横,点,撇,横,点,横,竖提,撇,竖弯钩,横,竖
筛	撇,横,点,撇,横,点,竖,撇,横,竖,横折钩,竖
筜	
筝	撇,横,点,撇,横,点,撇,横撇|横钩,横折,横,横,竖钩
筠	撇,横,点,撇,横,点,横,竖,提,撇,横折钩,点,提
筢	撇,横,点,撇,横,点,横,竖钩,提,横折,竖,横,竖弯钩
筤	
筥	
筦	
筮	撇,横,点,撇,横,点,横,竖,撇,点,撇,点,横
筱	撇,横,点,撇,横,点,撇,竖,竖,撇,横,撇,捺
筲	撇,横,点,撇,横,点,竖,点,撇,竖,横折钩,横,横
筵	撇,横,点,撇,横,点,撇,竖,横,竖弯,横折折撇,捺
筶	
筷	撇,横,点,撇,横,点,点2,点,竖,横折,横,撇,捺
筹	撇,横,点,撇,横,点,横,横,横,撇,横,竖钩,点
筻	撇,横,点,撇,横,点,横,竖,横折,横,横,撇,捺
筼	
签	撇,横,点,撇,横,点,撇,捺,横,点,点,撇,横
简	撇,横,点,撇,横,点,点,竖,横折钩,竖,横折,横,横
箅	撇,横,点,撇,横,点,竖,横折,横,竖,横,横,撇,竖
箍	撇,横,点,撇,横,点,横,竖钩,提,横,竖,横折钩,竖,竖弯
箐	撇,横,点,撇,横,点,横,横,竖,横,竖,横折钩,横,横
箓	
箔	撇,横,点,撇,横,点,点,点,提,撇,竖,横折,横,横
箕	撇,横,点,撇,横,点,横,竖,竖,横,横,横,撇,点
箖	
算	撇,横,点,撇,横,点,竖,横折,横,横,横,横,撇,竖
箜	撇,横,点,撇,横,点,点,点2,横撇|横钩,撇,点,横,竖,横
管	撇,横,点,撇,横,点,点,点2,横撇|横钩,竖,横折,横,横折,横
箢	撇,横,点,撇,横,点,点,点2,横撇|横钩,撇,横撇|横钩,点,横折钩,竖弯钩
箦	撇,横,点,撇,横,点,横,横,竖,横,竖,横折,撇,点
箧	撇,横,点,撇,横,点,横,横,点,撇,横,撇,点,竖弯
箨	撇,横,点,撇,横,点,横,竖钩,提,横撇|横钩,捺,横,横,竖
箩	撇,横,点,撇,横,点,竖,横折,竖,竖,横,撇,横撇|横钩,点
箪	撇,横,点,撇,横,点,点,撇,竖,横折,横,横,横,竖
箫	撇,横,点,撇,横,点,横折,横,横,竖,撇,竖,撇,点
箬	撇,横,点,撇,横,点,横,竖,竖,横,撇,竖,横折,横
箭	撇,横,点,撇,横,点,点,撇,横,竖,横折钩,横,横,竖,竖钩
箱	撇,横,点,撇,横,点,横,竖,撇,点,竖,横折,横,横,横
箴	撇,横,点,撇,横,点,横,撇,横,竖,横折,横,斜钩|卧钩,撇,点
箸	撇,横,点,撇,横,点,横,竖,横,撇,竖,横折,横,横
篁	撇,横,点,撇,横,点,撇,竖,横折,横,横,横,横,竖,横
篆	撇,横,点,撇,横,点,撇折,横撇|横钩,横,撇,弯钩,撇,撇,撇,捺
篇	撇,横,点,撇,横,点,点,横折,横,撇,竖,横折钩,横,竖,竖
篌	撇,横,点,撇,横,点,撇,竖,横折,横,撇,横,横,撇,捺
篑	撇,横,点,撇,横,点,竖,横折,横,竖,横,竖,横折,撇,点
篓	撇,横,点,撇,横,点,点,撇,横,竖,撇,捺,撇点,撇,横
篙	撇,横,点,撇,横,点,点,横,竖,横折,横,竖,横折钩,竖,横折,横
篚	撇,横,点,撇,横,点,横,竖,横,横,横,竖,横,横,横,竖弯
篝	撇,横,点,撇,横,点,横,横,竖,竖,横,竖,横折钩,竖,横,横
篡	撇,横,点,撇,横,点,竖,横折,横,横,横,横,撇,捺,撇折,点
篥	撇,横,点,撇,横,点,横,竖,横折,竖,竖,横,横,竖,撇,捺
篦	撇,横,点,撇,横,点,撇,竖,横折,撇,点,横,横,竖提,撇,竖弯钩
篪	撇,横,点,撇,横,点,撇,撇,竖,横,横撇|横钩,撇,横,竖弯钩,撇,横斜钩
篮	撇,横,点,撇,横,点,竖,竖,撇,横,点,竖,横折,竖,竖,横
篯	
篱	撇,横,点,撇,横,点,点,横,撇,点,竖弯,竖,竖,横折钩,撇折,点
篷	撇,横,点,撇,横,点,撇,横撇|横钩,捺,横,横,横,竖,点,横折折撇,捺
篼	撇,横,点,撇,横,点,撇,竖,横折,横,横,撇,竖提,横折,横,撇,竖弯钩
篾	撇,横,点,撇,横,点,竖,横折,竖,竖,横,横,撇,点,斜钩|卧钩,撇,点
簃	
簇	撇,横,点,撇,横,点,点,横,横折钩,撇,撇,横,撇,横,横,撇,捺
簉	
簋	撇,横,点,撇,横,点,横折,横,横,竖提,撇,捺,竖,横折,竖,竖,横
簌	撇,横,点,撇,横,点,横,竖,横折,横,竖,撇,点,撇,横撇|横钩,撇,捺
簏	撇,横,点,撇,横,点,点,横,撇,横折,竖,竖,横,横,竖提,撇,竖弯钩
簕	撇,横,点,撇,横,点,横,竖,竖,横,竖,横折,横,横,竖,横折钩,撇
簖	撇,横,点,撇,横,点,点,撇,横,竖,撇,点,竖弯,撇,撇,横,竖
簝	
簟	撇,横,点,撇,横,点,横,竖,横折,竖,竖,横,竖,横折,横,横,横,竖
簠	
簧	撇,横,点,撇,横,点,横,竖,竖,横,竖,横折,横,竖,横,撇,点
簪	撇,横,点,撇,横,点,横,撇折,撇,竖提,横,撇折,撇,竖弯钩,竖,横折,横,横
簰	
簸	撇,横,点,撇,横,点,横,竖,竖,横,横,横,撇,点,横撇|横钩,撇,竖,横撇|横钩,捺
簿	撇,横,点,撇,横,点,点,点,提,横,竖,横折,横,横,竖,点,横,竖钩,点
籀	撇,横,点,撇,横,点,横,竖钩,提,撇,竖提,点,横折钩,撇,竖,横折,横,竖,横
籁	撇,横,点,撇,横,点,横,竖,横折,横,竖,撇,点,撇,横撇|横钩,竖,横折,撇,点
籍	撇,横,点,撇,横,点,横,横,横,竖,撇,点,横,竖,竖,横,竖,横折,横,横
籥	撇,横,点,撇,横,点,撇,捺,横,竖,横折,横,竖,横折,横,竖,横折,横,竖,横折钩,横,竖,竖
米	点,撇,横,竖,撇,捺
籴	撇,捺,点,撇,横,竖,撇,捺
类	点,撇,横,竖,撇,点,横,撇,捺
籼	点,撇,横,竖,撇,点,竖,竖弯,竖
籽	点,撇,横,竖,撇,点,横撇|横钩,竖钩,横
粉	点,撇,横,竖,撇,点,撇,捺,横折钩,撇
粑	点,撇,横,竖,撇,点,横折,竖,横,竖弯钩
粒	点,撇,横,竖,撇,点,点,横,点,撇,横
粕	点,撇,横,竖,撇,点,撇,竖,横折,横,横
粗	点,撇,横,竖,撇,点,竖,横折,横,横,横
粘	点,撇,横,竖,撇,点,竖,横,竖,横折,横
粜	竖弯,竖,竖,竖弯,竖,点,撇,横,竖,撇,捺
粝	点,撇,横,竖,撇,点,横,撇,横,横折钩,撇
粞	点,撇,横,竖,撇,点,横,竖,横折,撇,竖弯,横
粟	横,竖,横折,竖,竖,横,点,撇,横,竖,撇,捺
粢	点,提,撇,横撇|横钩,撇,捺,点,撇,横,竖,撇,捺
粤	撇,竖,横折,点,撇,横,竖,撇,点,横,横,竖折折钩
粥	横折,横,竖折折钩,点,撇,横,竖,撇,点,横折,横,竖折折钩
粪	点,撇,横,竖,撇,捺,横,竖,竖,横,撇,点
粮	点,撇,横,竖,撇,点,点,横折,横,横,竖提,撇,捺
粱	点,点,提,横折钩,撇,点2,点,点,撇,横,竖,撇,捺
粲	竖,横,撇,横撇|横钩,点,横撇|横钩,点,点,撇,横,竖,撇,捺
粳	点,撇,横,竖,撇,点,横,竖,横折,横,横,撇,捺
粹	点,撇,横,竖,撇,点,点,横,撇,点,撇,点,横,竖
粼	点,撇,横,竖,撇,点,撇,横撇|横钩,点,横,撇折,竖,撇点,撇点
粽	点,撇,横,竖,撇,点,点,点2,横撇|横钩,横,横,竖钩,撇,点
精	点,撇,横,竖,撇,点,横,横,竖,横,竖,横折钩,横,横
粿	点,撇,横,竖,撇,点,竖,横折,横,横,横,竖,撇,捺
糁	点,撇,横,竖,撇,点,撇折,点,横,撇,捺,撇,撇,撇
糅	点,撇,横,竖,撇,点,横撇|横钩,点,横撇|横钩,竖钩,撇,横,竖,撇,捺
糇	点,撇,横,竖,撇,点,撇,竖,横折,横,撇,横,横,撇,捺
糈	点,撇,横,竖,撇,点,横撇|横钩,竖,横,撇,捺,竖,横折钩,横,横
糊	点,撇,横,竖,撇,点,横,竖,竖,横折,横,撇,横折钩,横,横
糌	点,撇,横,竖,撇,点,撇,横撇|横钩,捺,竖,点,竖,横折,横,横
糍	点,撇,横,竖,撇,点,点,撇,横,撇折,撇折,点,撇折,撇折,点
糒	
糕	点,撇,横,竖,撇,点,点,撇,横,横,竖,横,点2,点,点,点
糖	点,撇,横,竖,撇,点,点,横,撇,横折,横,横,竖,竖,横折,横
糗	点,撇,横,竖,撇,点,撇,竖,横折,横,横,横,横,撇,捺,点
糙	点,撇,横,竖,撇,点,撇,横,竖,横,竖,横折,横,点,横折折撇,捺
糜	点,横,撇,横,竖,撇,点,横,竖,撇,捺,点,撇,横,竖,撇,捺
糟	点,撇,横,竖,撇,点,横,竖,横折,横,竖,竖,横,竖,横折,横,横
糠	点,撇,横,竖,撇,点,点,横,撇,横折,横,横,竖钩,点,提,撇,捺
糨	点,撇,横,竖,撇,点,横折,横,竖折折钩,竖,横折,横,竖,横折,横,竖,横,点
糯	点,撇,横,竖,撇,点,横,点2,横撇|横钩,竖,点,点,点,点,横,撇,竖,横折钩,竖,竖
糵	
系	撇,撇折,撇折,点,竖钩,撇,点
紊	点,横,撇,捺,撇折,撇折,点,竖钩,撇,点
素	横,横,竖,横,撇折,撇折,点,竖钩,撇,点
索	横,竖,点2,横撇|横钩,撇折,撇折,点,竖钩,撇,点
紧	竖,竖,横撇|横钩,捺,撇折,撇折,点,竖钩,撇,点
紫	竖,横,竖,提,撇,竖弯钩,撇折,撇折,点,竖钩,撇,点
累	竖,横折,横,竖,横,撇折,撇折,点,竖钩,撇,点
絜	
絮	撇点,撇,横,竖,横折,横,撇折,撇折,点,竖钩,撇,点
絷	横,竖钩,提,撇,横斜钩,点,撇折,撇折,点,竖钩,撇,点
綦	横,竖,竖,横,横,横,撇,捺,撇折,撇折,点,竖钩,撇,点
綮	点,横折,横,撇,撇,横,撇,捺,撇折,撇折,点,竖钩,撇,点
縠	
縢	
縻	点,横,撇,横,竖,撇,点,横,竖,撇,捺,撇折,撇折,点,竖钩,撇,点
繁	撇,横,竖弯,横折钩,点,横,点,撇,横,撇,捺,撇折,撇折,点,竖钩,撇,点
繄	
繇	撇,点,点,撇,撇,横,横,竖,竖弯,竖,撇,撇折,撇折,点,竖钩,撇,点
纂	撇,横,点,撇,横,点,竖,横折,横,横,横,横,撇,捺,撇折,撇折,点,竖钩,撇,点
纛	横,横,竖,横,竖弯,横折,点,横,点,竖,横折,横,横,横,横,竖钩,撇,点,撇,撇折,撇折,点,竖钩,撇,点
纠	撇折,撇折,提,竖提,竖
纡	撇折,撇折,提,横,横,竖钩
红	撇折,撇折,提,横,竖,横
纣	撇折,撇折,提,横,竖钩,点
纤	撇折,撇折,提,撇,横,竖
纥	撇折,撇折,提,撇,横,横斜钩
约	撇折,撇折,提,撇,横折钩,点
级	撇折,撇折,提,撇,横折折撇,捺
纨	撇折,撇折,提,撇,横斜钩,点
纩	撇折,撇折,提,点,横,撇
纪	撇折,撇折,提,横折,横,竖弯钩
纫	撇折,撇折,提,横折钩,撇,点2
纬	撇折,撇折,提,横,横,横折钩,竖
纭	撇折,撇折,提,横,横,撇折,点
纮	
纯	撇折,撇折,提,横,竖弯,竖,竖弯钩
纰	撇折,撇折,提,横,竖提,撇,竖弯钩
纱	撇折,撇折,提,竖,撇,点,撇
纲	撇折,撇折,提,竖,横折钩,撇,点
纳	撇折,撇折,提,竖,横折钩,撇,点
纴	
纵	撇折,撇折,提,撇,点,撇,捺
纶	撇折,撇折,提,撇,捺,撇,竖弯钩
纷	撇折,撇折,提,撇,捺,横折钩,撇
纸	撇折,撇折,提,撇,竖提,横,斜钩|卧钩
纹	撇折,撇折,提,点,横,撇,捺
纺	撇折,撇折,提,点,横,横折钩,撇
纻	
纼	
纽	撇折,撇折,提,横折,竖,横,横
纾	撇折,撇折,提,横撇|横钩,点,横撇|横钩,竖钩
线	撇折,撇折,提,横,横,斜钩|卧钩,撇,点
绀	撇折,撇折,提,横,竖,竖,横,横
绁	撇折,撇折,提,横,竖,竖,横,竖弯
绂	撇折,撇折,提,横,撇,横撇|横钩,捺,点
练	撇折,撇折,提,横,撇折,横折钩,撇,点
组	撇折,撇折,提,竖,横折,横,横,横
绅	撇折,撇折,提,竖,横折,横,横,竖
细	撇折,撇折,提,竖,横折,横,竖,横
织	撇折,撇折,提,竖,横折,横,撇,点
终	撇折,撇折,提,撇,横撇|横钩,捺,点,点
绉	撇折,撇折,提,撇,横撇|横钩,横折,横,横
绊	撇折,撇折,提,点,撇,横,横,竖
绋	撇折,撇折,提,横折,横,竖折折钩,撇,竖
绌	撇折,撇折,提,竖弯,竖,竖,竖弯,竖
绍	撇折,撇折,提,横折钩,撇,竖,横折,横
绎	撇折,撇折,提,横撇|横钩,捺,横,横,竖
经	撇折,撇折,提,横撇|横钩,点,横,竖,横
绐	撇折,撇折,提,撇折,点,竖,横折,横
绑	撇折,撇折,提,横,横,横,撇,横折折折钩|横撇弯钩,竖
绒	撇折,撇折,提,横,横,撇,斜钩|卧钩,撇,点
结	撇折,撇折,提,横,竖,横,竖,横折,横
绔	撇折,撇折,提,横,撇,捺,横,横,竖折折钩
绕	撇折,撇折,提,横,斜钩|卧钩,撇,横,撇,竖弯钩
绖	
绗	撇折,撇折,提,撇,撇,竖,横,横,竖钩
绘	撇折,撇折,提,撇,捺,横,横,撇折,点
给	撇折,撇折,提,撇,捺,横,竖,横折,横
绚	撇折,撇折,提,撇,横折钩,竖,横折,横,横
绛	撇折,撇折,提,撇,横撇|横钩,捺,横,撇折,竖
络	撇折,撇折,提,撇,横撇|横钩,捺,竖,横折,横
绝	撇折,撇折,提,撇,横撇|横钩,横折,竖,横,竖弯钩
绞	撇折,撇折,提,点,横,撇,点,撇,捺
统	撇折,撇折,提,点,横,撇折,点,撇,竖弯钩
绠	撇折,撇折,提,横,竖,横折,横,横,撇,捺
绡	撇折,撇折,提,竖,点,撇,竖,横折钩,横,横
绢	撇折,撇折,提,竖,横折,横,竖,横折钩,横,横
绣	撇折,撇折,提,撇,横,竖,撇,捺,横折折折钩|横撇弯钩,撇
绤	
绥	撇折,撇折,提,撇,点,点,撇,撇点,撇,横
绦	撇折,撇折,提,撇,横撇|横钩,捺,横,竖钩,撇,点
继	撇折,撇折,提,点,撇,横,竖,撇,点,竖弯
绨	撇折,撇折,提,点,撇,横折,横,竖折折钩,竖,撇
绩	撇折,撇折,提,横,横,竖,横,竖,横折,撇,点
绪	撇折,撇折,提,横,竖,横,撇,竖,横折,横,横
绫	撇折,撇折,提,横,竖,横,撇,点,撇,横撇|横钩,捺
续	撇折,撇折,提,横,竖,横撇|横钩,点,点,横,撇,点
绮	撇折,撇折,提,横,撇,点,横,竖,横折,横,竖钩
绯	撇折,撇折,提,竖,横,横,横,竖,横,横,横
绰	撇折,撇折,提,竖,横,竖,横折,横,横,横,竖
绱	撇折,撇折,提,竖,点,撇,竖,横折钩,竖,横折,横
绲	撇折,撇折,提,竖,横折,横,横,横,竖提,撇,竖弯钩
绳	撇折,撇折,提,竖,横折,横,竖,横折,横,横,竖弯钩
维	撇折,撇折,提,撇,竖,点,横,横,横,竖,横
绵	撇折,撇折,提,撇,竖,横折,横,横,竖,横折钩,竖
绶	撇折,撇折,提,撇,点,点,撇,点2,横撇|横钩,横撇|横钩,捺
绷	撇折,撇折,提,撇,横折钩,横,横,撇,横折钩,横,横
绸	撇折,撇折,提,撇,横折钩,横,竖,横,竖,横折,横
绹	
绺	撇折,撇折,提,撇,横撇|横钩,捺,竖,点,竖,横折,横
绻	撇折,撇折,提,点,撇,横,横,撇,捺,横折钩,竖弯钩
综	撇折,撇折,提,点,点2,横撇|横钩,横,横,竖钩,撇,点
绽	撇折,撇折,提,点,点2,横撇|横钩,横,竖,横,撇,捺
绾	撇折,撇折,提,点,点2,横撇|横钩,竖,横折,横,横折,横
绿	撇折,撇折,提,横折,横,横,竖钩,点,提,撇,捺
缀	撇折,撇折,提,横撇|横钩,点,横撇|横钩,点,横撇|横钩,点,横撇|横钩,捺
缁	撇折,撇折,提,撇点,撇点,撇点,竖,横折,横,竖,横
缂	撇折,撇折,提,横,竖,竖,横,竖,横折,横,横,竖
缃	撇折,撇折,提,横,竖,撇,点,竖,横折,横,横,横
缄	撇折,撇折,提,横,撇,横,竖,横折,横,斜钩|卧钩,撇,点
缅	撇折,撇折,提,横,撇,竖,横折,竖,竖,横,横,横
缆	撇折,撇折,提,竖,竖,撇,横,点,竖,横折,撇,竖弯钩
缇	撇折,撇折,提,竖,横折,横,横,横,竖,横,撇,捺
缈	撇折,撇折,提,竖,横折,横,横,横,竖,撇,点,撇
缉	撇折,撇折,提,竖,横折,横,横,竖,竖,横,横,横
缊	
缌	撇折,撇折,提,竖,横折,横,竖,横,点2,斜钩|卧钩,点,点
缎	撇折,撇折,提,撇,竖,横,横,提,撇,横折折|横折弯,横撇|横钩,捺
缐	
缑	撇折,撇折,提,撇,竖,横折,横,撇,横,横,撇,捺
缒	撇折,撇折,提,撇,竖,横折,横,横折,横,点,横折折撇,捺
缓	撇折,撇折,提,撇,点,点,撇,横,横,撇,横撇|横钩,捺
缔	撇折,撇折,提,点,横,点,撇,点2,横撇|横钩,竖,横折钩,竖
缕	撇折,撇折,提,点,撇,横,竖,撇,捺,撇点,撇,横
编	撇折,撇折,提,点,横折,横,撇,竖,横折钩,横,竖,竖
缗	撇折,撇折,提,横折,横,竖提,横,斜钩|卧钩,竖,横折,横,横
缘	撇折,撇折,提,撇折,横撇|横钩,横,撇,弯钩,撇,撇,撇,捺
缙	撇折,撇折,提,横,竖,竖,点,撇,横,竖,横折,横,横
缚	撇折,撇折,提,横,竖,横折,横,横,竖,点,横,竖钩,点
缛	撇折,撇折,提,横,撇,横,横,竖提,撇,捺,横,竖钩,点
缜	撇折,撇折,提,横,竖,竖,横折,横,横,横,横,撇,点
缝	撇折,撇折,提,撇,横撇|横钩,捺,横,横,横,竖,点,横折折撇,捺
缞	
缟	撇折,撇折,提,点,横,竖,横折,横,竖,横折钩,竖,横折,横
缠	撇折,撇折,提,点,横,撇,竖,横折,横,横,竖,横,横
缡	撇折,撇折,提,点,横,撇,点,竖弯,竖,竖,横折钩,撇折,点
缢	撇折,撇折,提,点,撇,横,撇,点,竖,横折,竖,竖,横
缣	撇折,撇折,提,点,撇,横,横折,横,横,竖,竖,撇,捺
缤	撇折,撇折,提,点,点2,横撇|横钩,撇,竖,横,竖,横,撇,点
缥	撇折,撇折,提,横,竖,横折,竖,竖,横,横,横,竖钩,撇,点
缦	撇折,撇折,提,竖,横折,横,横,竖,横折,竖,竖,横,横撇|横钩,捺
缧	撇折,撇折,提,竖,横折,横,竖,横,撇折,撇折,点,竖钩,撇,点
缨	撇折,撇折,提,竖,横折,撇,点,竖,横折,撇,点,撇点,撇,横
缩	撇折,撇折,提,点,点2,横撇|横钩,撇,竖,横,撇,竖,横折,横,横
缪	撇折,撇折,提,横折,点,提,横折,点,提,撇,捺,撇,撇,撇
缫	撇折,撇折,提,撇点,撇点,撇点,竖,横折,横,横,横,竖,撇,捺
缬	撇折,撇折,提,横,竖,横,竖,横折,横,横,撇,竖,横折,撇,点
缭	撇折,撇折,提,横,撇,捺,点,撇,竖,横折,横,横,竖钩,撇,点
缮	撇折,撇折,提,点,撇,横,横,横,竖,点,撇,横,竖,横折,横
缯	撇折,撇折,提,点,撇,竖,横折,竖,点,撇,横,竖,横折,横,横
缰	撇折,撇折,提,横,竖,横折,横,竖,横,横,竖,横折,横,竖,横,横
缱	撇折,撇折,提,竖,横折,横,竖,横,竖,横折,横,横折,横,点,横折折撇,捺
缲	撇折,撇折,提,竖,横折,横,竖,横折,横,竖,横折,横,横,竖,撇,捺
缳	撇折,撇折,提,竖,横折,竖,竖,横,横,竖,横折,横,撇,竖提,撇,捺
缴	撇折,撇折,提,撇,竖,横折,横,横,点,横,横折钩,撇,撇,横,撇,捺
缵	撇折,撇折,提,撇,横,竖,横,撇,竖提,撇,横,竖,横,撇,竖弯钩,竖,横折,撇,点
缶	撇,横,横,竖,竖弯,竖
缸	撇,横,横,竖,竖弯,竖,横,竖,横
缺	撇,横,横,竖,竖弯,竖,横折,横,撇,捺
罂	竖,横折,撇,点,竖,横折,撇,点,撇,横,横,竖,竖弯,竖
罄	横,竖,横,横折,竖,横,撇,撇,横折折|横折弯,横撇|横钩,点,撇,横,横,竖,竖弯,竖
罅	撇,横,横,竖,竖弯,竖,竖,横,横撇|横钩,撇,横,竖弯钩,撇,点,撇,横,竖钩
罍	竖,横折,横,竖,横,竖,横折,横,竖,横,竖,横折,横,竖,横,撇,横,横,竖,竖弯,竖
罐	撇,横,横,竖,竖弯,竖,横,竖,竖,竖,横折,横,竖,横折,横,撇,竖,点,横,横,横,竖,横
网	竖,横折钩,撇,点,撇,点
罔	竖,横折钩,点,撇,横,点,横,竖弯
罕	点2,横撇|横钩,撇,点,横,横,竖
罗	竖,横折,竖,竖,横,撇,横撇|横钩,点
罘	竖,横折,竖,竖,横,横,撇,竖,点
罚	竖,横折,竖,竖,横,点,横折提,竖,竖钩
罟	竖,横折,竖,竖,横,横,竖,竖,横折,横
罡	竖,横折,竖,竖,横,横,竖,横,竖,横
罢	竖,横折,竖,竖,横,横,竖,横,撇折,点
罨	竖,横折,竖,竖,横,横,撇,捺,竖,横折,横,横,竖弯钩
罩	竖,横折,竖,竖,横,竖,横,竖,横折,横,横,横,竖
罪	竖,横折,竖,竖,横,竖,横,横,横,竖,横,横,横
置	竖,横折,竖,竖,横,横,竖,竖,横折,横,横,横,横
罱	竖,横折,竖,竖,横,横,竖,竖,横折钩,点,撇,横,横,竖
署	竖,横折,竖,竖,横,横,竖,横,撇,竖,横折,横,横
罴	竖,横折,竖,竖,横,横,竖,横,撇折,点,点2,点,点,点
罶	
罹	竖,横折,竖,竖,横,点2,点,竖,撇,竖,点,横,横,横,竖,横
罽	
罾	竖,横折,竖,竖,横,点,撇,竖,横折,竖,点,撇,横,竖,横折,横,横
羁	竖,横折,竖,竖,横,横,竖,竖,横,竖,横折,横,横,竖,横折,竖折折钩,横
羊	点,撇,横,横,横,竖
羌	点,撇,横,横,横,撇,竖弯钩
美	点,撇,横,横,竖,横,横,撇,捺
羑	
羓	
羔	点,撇,横,横,竖,横,点2,点,点,点
羕	
羖	
羚	点,撇,横,横,横,撇,撇,捺,点,横撇|横钩,点
羝	点,撇,横,横,横,撇,撇,竖提,横,斜钩|卧钩,点
羞	点,撇,横,横,横,撇,横折,竖,横,横
羟	点,撇,横,横,横,撇,横撇|横钩,点,横,竖,横
羡	点,撇,横,横,竖,横,点,提,撇,横撇|横钩,撇,捺
群	横折,横,横,撇,竖,横折,横,点,撇,横,横,横,竖
羧	点,撇,横,横,横,撇,撇折,点,撇,点,撇,横撇|横钩,捺
羯	点,撇,横,横,横,撇,竖,横折,横,横,撇,横折钩,撇,点,竖弯
羰	点,撇,横,横,横,撇,竖,竖弯,竖,横,撇,点2,撇,撇,捺
羱	
羲	点,撇,横,横,竖,横,撇,横,竖,撇,点,横,竖折折钩,斜钩|卧钩,撇,点
羸	点,横,竖弯,竖,横折,横,撇,横折钩,横,横,点,撇,横,横,横,竖,撇,横斜钩,点
羹	点,撇,横,横,竖,横,点2,点,点,点,点,撇,横,横,竖,横,横,撇,捺
羼	横折,横,撇,点,撇,横,横,横,竖,点,撇,横,横,横,撇,点,撇,横,横,横,竖
羽	横折钩,点,提,横折钩,点,提
羿	横折,点,提,横折,点,提,横,撇,竖
翀	横折钩,点,提,横折钩,点,提,竖,横折,横,竖
翁	撇,捺,撇折,点,横折钩,点,提,横折钩,点,提
翂	
翃	横,撇,撇折,点,横折钩,点,提,横折钩,点,提
翅	横,竖,横撇|横钩,捺,横折钩,点,提,横折钩,点,提
翈	
翊	点,横,点,撇,提,横折钩,点,提,横折钩,点,提
翌	横折,点,提,横折,点,提,点,横,点,撇,横
翎	撇,点,点,横撇|横钩,点,横折钩,点,提,横折钩,点,提
翔	点,撇,横,横,横,撇,横折钩,点,提,横折钩,点,提
翕	撇,捺,横,竖,横折,横,横折钩,点,提,横折钩,点,提
翘	横,斜钩|卧钩,撇,横,撇,竖弯钩,横折钩,点,提,横折钩,点,提
翙	
翚	横折,点,提,横折,点,提,点2,横撇|横钩,横,撇折,横,竖
翛	
翟	横折,点,提,横折,点,提,撇,竖,点,横,横,横,竖,横
翠	横折,点,提,横折,点,提,点,横,撇,点,撇,点,横,竖
翡	竖,横,横,横,竖,横,横,横,横折钩,点,提,横折钩,点,提
翥	横,竖,横,撇,竖,横折,横,横,横折钩,点,提,横折钩,点,提
翦	点,撇,横,竖,横折钩,横,横,竖,竖钩,横折钩,点,提,横折钩,点,提
翩	点,横折,横,撇,竖,横折钩,横,竖,竖,横折钩,点,提,横折钩,点,提
翮	横,竖,横折,横,竖,横折钩,点,撇,横,竖,横折钩,点,提,横折钩,点,提
翯	
翰	横,竖,竖,横折,横,横,横,竖,撇,捺,横折钩,点,提,横折钩,点,提
翱	撇,竖,横折,横,横,横,撇,点,横,竖,横折钩,点,提,横折钩,点,提
翳	横,撇,横,横,撇,点,竖弯,撇,横折折|横折弯,横撇|横钩,捺,横折钩,点,提,横折钩,点,提
翷	
翻	撇,点,撇,横,竖,撇,点,竖,横折,横,竖,横,横折钩,点,提,横折钩,点,提
翼	横折,点,提,横折,点,提,竖,横折,横,竖,横,横,竖,竖,横,撇,点
翾	
耀	竖,点,撇,横,撇,竖提,横折,点,提,横折,点,提,撇,竖,点,横,横,横,竖,横
老	横,竖,横,撇,撇,竖弯钩
考	横,竖,横,撇,横,竖折折钩
耄	横,竖,横,撇,撇,竖弯钩,撇,横,横,竖弯钩
者	横,竖,横,撇,竖,横折,横,横
耆	横,竖,横,撇,撇,竖弯钩,竖,横折,横,横
耇	
耋	横,竖,横,撇,撇,竖弯钩,横,撇折,点,横,竖,横
而	横,撇,竖,横折钩,竖,竖
耍	横,撇,竖,横折钩,竖,竖,撇点,撇,横
耏	
耐	横,撇,竖,横折钩,竖,竖,横,竖钩,点
耑	竖,竖弯,竖,横,撇,竖,横折钩,竖,竖
耒	横,横,横,竖,撇,捺
耔	横,横,横,竖,撇,点,横撇|横钩,竖钩,横
耕	横,横,横,竖,撇,点,横,横,撇,竖
耖	横,横,横,竖,撇,点,竖,撇,点,撇
耗	横,横,横,竖,撇,点,撇,横,横,竖弯钩
耘	横,横,横,竖,撇,点,横,横,撇折,点
耙	横,横,横,竖,撇,点,横折,竖,横,竖弯钩
耜	横,横,横,竖,撇,点,竖,横折,横,横折,横
耠	横,横,横,竖,撇,点,撇,捺,横,竖,横折,横
耢	横,横,横,竖,撇,点,横,竖,竖,点2,横撇|横钩,横折钩,撇
耤	
耥	横,横,横,竖,撇,点,竖,点,撇,竖,横折钩,竖,横折,横
耦	横,横,横,竖,撇,点,竖,横折,横,横,竖,横折钩,竖,提,点
耧	横,横,横,竖,撇,点,点,撇,横,竖,撇,捺,撇点,撇,横
耨	横,横,横,竖,撇,点,横,撇,横,横,竖提,撇,捺,横,竖钩,点
耩	横,横,横,竖,撇,点,横,横,竖,竖,横,竖,横折钩,竖,横,横
耪	横,横,横,竖,撇,点,点,横,点,撇,点2,横撇|横钩,点,横,横折钩,撇
耰	
耱	横,横,横,竖,撇,点,点,横,撇,横,竖,撇,点,横,竖,撇,捺,横,撇,竖,横折,横
耳	横,竖,竖,横,横,横
耵	横,竖,竖,横,横,提,横,竖钩
耶	横,竖,竖,横,横,提,横折折折钩|横撇弯钩,竖
耷	横,撇,捺,横,竖,竖,横,横,横
耸	撇,点,撇,捺,横,竖,竖,横,横,横
耻	横,竖,竖,横,横,提,竖,横,竖,横
耽	横,竖,竖,横,横,提,点2,横撇|横钩,撇,竖弯钩
耿	横,竖,竖,横,横,提,点2,撇,撇,捺
聂	横,竖,竖,横,横,横,横撇|横钩,点,横撇|横钩,捺
聃	横,竖,竖,横,横,提,竖,横折钩,竖,横,横
聆	横,竖,竖,横,横,提,撇,捺,点,横撇|横钩,点
聊	横,竖,竖,横,横,提,撇,竖提,撇,横折钩,竖
聋	横,撇,竖弯钩,撇,点,横,竖,竖,横,横,横
职	横,竖,竖,横,横,提,竖,横折,横,撇,点
聍	横,竖,竖,横,横,提,点,点2,横撇|横钩,横,竖钩
聒	横,竖,竖,横,横,提,撇,横,竖,竖,横折,横
联	横,竖,竖,横,横,提,点,撇,横,横,撇,捺
聘	横,竖,竖,横,横,提,竖,横折,横,竖,横,横,竖折折钩
聚	横,竖,竖,横,横,提,横撇|横钩,点,撇,竖,撇,撇,撇,捺
聩	横,竖,竖,横,横,提,竖,横折,横,竖,横,竖,横折,撇,点
聪	横,竖,竖,横,横,提,点,撇,竖,横折,横,点2,斜钩|卧钩,点,点
聱	横,横,竖,横,横折钩,撇,撇,横,撇,捺,横,竖,竖,横,横,横
聿	横折,横,横,横,横,竖
肃	横折,横,横,竖,撇,竖,撇,点
肄	撇,竖弯钩,撇,横,横,撇,点,横折,横,横,横,横,竖
肆	横,竖,横,横,横,撇折,点,横折,横,横,横,横,竖
肇	点,横折,横,撇,撇,横,撇,捺,横折,横,横,横,横,竖
肉	竖,横折钩,撇,点,撇,点
肋	撇,横折钩,横,横,横折钩,撇
肌	撇,横折钩,横,横,撇,横斜钩
肓	点,横,竖弯,竖,横折钩,横,横
肖	竖,点,撇,竖,横折钩,横,横
肘	撇,横折钩,横,横,横,竖钩,点
肚	撇,横折钩,横,横,横,竖,横
肛	撇,横折钩,横,横,横,竖,横
肝	撇,横折钩,横,横,横,横,竖
肟	撇,横折钩,横,横,横,横,竖折折钩
肠	撇,横折钩,横,横,横折折折钩|横撇弯钩,撇,撇
股	撇,横折钩,横,横,撇,横折折|横折弯,横撇|横钩,捺
肢	撇,横折钩,横,横,横,竖,横撇|横钩,捺
肤	撇,横折钩,横,横,横,横,撇,捺
肥	撇,横折钩,横,横,横折,竖,横,竖弯钩
肩	点,横折,横,撇,竖,横折钩,横,横
肪	撇,横折钩,横,横,点,横,横折钩,撇
肫	撇,横折钩,横,横,横,竖弯,竖,竖弯钩
肭	撇,横折钩,横,横,竖,横折钩,撇,点
肮	撇,横折钩,横,横,点,横,撇,横斜钩
肯	竖,横,竖,横,竖,横折钩,横,横
肱	撇,横折钩,横,横,横,撇,撇折,点
育	点,横,撇折,点,竖,横折钩,横,横
肴	撇,点,横,撇,竖,横折钩,横,横
肷	撇,横折钩,横,横,撇,横撇|横钩,撇,捺
肸	
肺	撇,横折钩,横,横,横,竖,横折钩,竖
肼	撇,横折钩,横,横,横,横,撇,竖
肽	撇,横折钩,横,横,横,撇,捺,点
肾	竖,竖,横撇|横钩,捺,竖,横折钩,横,横
肿	撇,横折钩,横,横,竖,横折,横,竖
胀	撇,横折钩,横,横,撇,横,竖提,捺
胁	撇,横折钩,横,横,横折钩,撇,点2,点
胂	撇,横折钩,横,横,竖,横折,横,横,竖
胃	竖,横折,横,竖,横,竖,横折钩,横,横
胄	竖,横折,横,竖,横,竖,横折钩,横,横
胆	撇,横折钩,横,横,竖,横折,横,横,横
胈	
背	竖,横,提,撇,竖弯钩,竖,横折钩,横,横
胍	撇,横折钩,横,横,撇,撇,竖提,点,捺
胎	撇,横折钩,横,横,撇折,点,竖,横折,横
胖	撇,横折钩,横,横,点,撇,横,横,竖
胗	撇,横折钩,横,横,撇,捺,撇,撇,撇
胙	撇,横折钩,横,横,撇,横,竖,横,横
胚	撇,横折钩,横,横,横,撇,竖,点,横
胛	撇,横折钩,横,横,竖,横折,横,横,竖
胜	撇,横折钩,横,横,撇,横,横,竖,横
胝	撇,横折钩,横,横,撇,竖提,横,斜钩|卧钩,点
胞	撇,横折钩,横,横,撇,横折钩,横折,横,竖弯钩
胠	
胡	横,竖,竖,横折,横,撇,横折钩,横,横
胣	
胤	撇,撇折,撇折,点,竖,横折钩,横,横,竖弯钩
胥	横撇|横钩,竖,横,撇,捺,竖,横折钩,横,横
胧	撇,横折钩,横,横,横,撇,竖弯钩,撇,点
胨	撇,横折钩,横,横,横,撇折,竖钩,撇,点
胩	撇,横折钩,横,横,竖,横,横,竖,点
胪	撇,横折钩,横,横,竖,横,横折,横,撇
胫	撇,横折钩,横,横,横撇|横钩,点,横,竖,横
胬	撇点,撇,横,横撇|横钩,捺,竖,横折钩,撇,点,撇,点
胭	撇,横折钩,横,横,竖,横折,横,撇,点,横
胯	撇,横折钩,横,横,横,撇,捺,横,横,竖折折钩
胰	撇,横折钩,横,横,横,横折,横,竖折折钩,撇,捺
胱	撇,横折钩,横,横,竖,点,撇,横,撇,竖弯钩
胲	撇,横折钩,横,横,点,横,撇折,撇,撇,点
胳	撇,横折钩,横,横,撇,横撇|横钩,捺,竖,横折,横
胴	撇,横折钩,横,横,竖,横折钩,横,竖,横折,横
胶	撇,横折钩,横,横,点,横,撇,点,撇,捺
胸	撇,横折钩,横,横,撇,横折钩,撇,点,竖弯,竖
胺	撇,横折钩,横,横,点,点2,横撇|横钩,撇点,撇,横
胼	撇,横折钩,横,横,点,撇,横,横,撇,竖
能	撇折,点,竖,横折钩,横,横,撇,竖弯钩,撇,竖弯钩
脂	撇,横折钩,横,横,撇,竖弯钩,竖,横折,横,横
脆	撇,横折钩,横,横,撇,横撇|横钩,横,撇,横折钩,竖弯钩
脉	撇,横折钩,横,横,点,横折钩,横撇|横钩,撇,捺
脊	点,提,撇,点,撇,捺,竖,横折钩,横,横
脍	撇,横折钩,横,横,撇,捺,横,横,撇折,点
脎	撇,横折钩,横,横,撇,点,横,竖钩,撇,点
脏	撇,横折钩,横,横,点,横,撇,横,竖,横
脐	撇,横折钩,横,横,点,横,撇,捺,撇,竖
脑	撇,横折钩,横,横,点,横,撇,点,竖弯,竖
脒	撇,横折钩,横,横,点,撇,横,竖,撇,捺
脓	撇,横折钩,横,横,点2,横撇|横钩,撇,竖提,撇,捺
脔	点,横,竖,竖,撇,点,竖,横折钩,撇,点,撇,点
脖	撇,横折钩,横,横,横,竖,点2,横撇|横钩,横撇|横钩,竖钩,横
脘	撇,横折钩,横,横,点,点2,横撇|横钩,横,横,撇,竖弯钩
脚	撇,横折钩,横,横,横,竖,横,撇折,点,横折钩,竖
脞	撇,横折钩,横,横,撇,点,撇,点,横,竖,横
脟	
脩	撇,竖,竖,撇,横撇|横钩,捺,竖,横折钩,横,横
脬	撇,横折钩,横,横,撇,点,点,撇,横撇|横钩,竖钩,横
脯	撇,横折钩,横,横,横,竖,横折钩,横,横,竖,点
脱	撇,横折钩,横,横,点,撇,竖,横折,横,撇,竖弯钩
脲	撇,横折钩,横,横,横折,横,撇,竖钩,横撇|横钩,撇,捺
脶	撇,横折钩,横,横,竖,横折,横,竖,横折钩,撇,点
脸	撇,横折钩,横,横,撇,捺,横,点,点,撇,横
脾	撇,横折钩,横,横,撇,竖,横折,横,横,撇,横,竖
脿	
腆	撇,横折钩,横,横,竖,横折,横,竖,竖,横,撇,点
腈	撇,横折钩,横,横,横,横,竖,横,竖,横折钩,横,横
腊	撇,横折钩,横,横,横,竖,竖,横,竖,横折,横,横
腋	撇,横折钩,横,横,点,横,撇,竖,撇,横撇|横钩,点,捺
腌	撇,横折钩,横,横,横,撇,捺,竖,横折,横,横,竖弯钩
腐	点,横,撇,撇,竖,横,竖钩,点,竖,横折钩,撇,点,撇,点
腑	撇,横折钩,横,横,点,横,撇,撇,竖,横,竖钩,点
腒	
腓	撇,横折钩,横,横,竖,横,横,横,竖,横,横,横
腔	撇,横折钩,横,横,点,点2,横撇|横钩,撇,点,横,竖,横
腕	撇,横折钩,横,横,点,点2,横撇|横钩,撇,横撇|横钩,点,横折钩,竖弯钩
腘	
腙	撇,横折钩,横,横,点,点2,横撇|横钩,横,横,竖钩,撇,点
腚	撇,横折钩,横,横,点,点2,横撇|横钩,横,竖,横,撇,捺
腠	撇,横折钩,横,横,横,横,横,撇,捺,横,横,撇,点
腥	撇,横折钩,横,横,竖,横折,横,横,撇,横,横,竖,横
腧	撇,横折钩,横,横,撇,捺,横,竖,横折钩,横,横,竖,竖钩
腨	
腩	撇,横折钩,横,横,横,竖,竖,横折钩,点,撇,横,横,竖
腭	撇,横折钩,横,横,竖,横折,横,竖,横折,横,横,横,竖折折钩
腮	撇,横折钩,横,横,竖,横折,横,竖,横,点2,斜钩|卧钩,点,点
腯	
腰	撇,横折钩,横,横,横,竖,横折,竖,竖,横,撇点,撇,横
腱	撇,横折钩,横,横,横折,横,横,横,横,竖,横折折撇,捺
腴	撇,横折钩,横,横,撇,竖,横,横折,横,横,撇,捺
腹	撇,横折钩,横,横,撇,横,竖,横折,横,横,撇,横撇|横钩,捺
腺	撇,横折钩,横,横,撇,竖,横折,横,横,竖钩,横撇|横钩,撇,捺
腻	撇,横折钩,横,横,横,横,横,竖,横折,撇,点,斜钩|卧钩,点
腼	撇,横折钩,横,横,横,撇,竖,横折,竖,竖,横,横,横
腽	撇,横折钩,横,横,竖,横折,横,横,竖,横折,竖,竖,横
腾	撇,横折钩,横,横,点,撇,横,横,撇,捺,横折,竖折折钩,横
腿	撇,横折钩,横,横,横折,横,横,竖提,撇,点,点,横折折撇,捺
膀	撇,横折钩,横,横,点,横,点,撇,点2,横撇|横钩,点,横,横折钩,撇
膂	点,横,横折钩,撇,撇,横,撇,竖提,撇,捺,竖,横折钩,横,横
膈	撇,横折钩,横,横,横,竖,横折,横,竖,横折钩,点,撇,横,竖
膊	撇,横折钩,横,横,横,竖,横折,横,横,竖,点,横,竖钩,点
膏	点,横,竖,横折,横,点2,横撇|横钩,竖,横折,横,竖,横折钩,横,横
膑	撇,横折钩,横,横,点,点2,横撇|横钩,撇,竖,横,竖,横,撇,点
膘	撇,横折钩,横,横,横,竖,横折,竖,竖,横,横,横,竖钩,撇,点
膙	
膛	撇,横折钩,横,横,竖,点,撇,点2,横撇|横钩,竖,横折,横,横,竖,横
膜	撇,横折钩,横,横,横,竖,竖,竖,横折,横,横,横,撇,捺
膝	撇,横折钩,横,横,横,竖,撇,点,撇,捺,竖钩,点,提,点2,点
膦	撇,横折钩,横,横,点,撇,横,竖,撇,捺,撇,横撇|横钩,点,横,撇折,竖
膨	撇,横折钩,横,横,横,竖,横,竖,横折,横,点,撇,提,撇,撇,撇
膳	撇,横折钩,横,横,点,撇,横,横,横,竖,点,撇,横,竖,横折,横
膺	点,横,撇,撇,竖,撇,竖,点,横,横,横,竖,横,竖,横折钩,横,横
膻	撇,横折钩,横,横,点,横,竖,横折,竖,横折,横,横,竖,横折,横,横,横
臀	横折,横,撇,横,竖,竖,横,撇,点,撇,横折折|横折弯,横撇|横钩,捺,竖,横折钩,横,横
臂	横折,横,撇,竖,横折,横,点,横,点,撇,横,横,竖,竖,横折钩,横,横
臃	撇,横折钩,横,横,点,横,撇折,撇折,撇,撇,竖,点,横,横,横,竖,横
臆	撇,横折钩,横,横,点,横,点,撇,横,竖,横折,横,横,点2,斜钩|卧钩,点,点
臊	撇,横折钩,横,横,竖,横折,横,竖,横折,横,竖,横折,横,横,竖,撇,捺
臌	撇,横折钩,横,横,横,竖,横,竖,横折,横,点,撇,提,横,竖,横撇|横钩,捺
臑	
臜	
臣	横,竖,横折,横,竖,竖弯
臧	横,撇,竖弯,横,撇,横,竖,横折,横,竖,竖弯,斜钩|卧钩,撇,点
自	撇,竖,横折,横,横,横
臬	撇,竖,横折,横,横,横,横,竖,撇,捺
臭	撇,竖,横折,横,横,横,横,撇,捺,点
至	横,撇折,点,横,竖,横
致	横,撇折,点,横,竖,提,撇,横,撇,捺
臻	横,撇折,点,横,竖,提,横,横,横,撇,捺,撇,横,竖,撇,点
臼	撇,竖,横,横折,横,横
臾	撇,竖,横,横折,横,横,撇,捺
舀	撇,点,点,撇,撇,竖,横,横折,横,横
舁	撇,竖,横,横折,横,横,横,撇,竖
舂	横,横,横,撇,捺,撇,竖,横,横折,横,横
舄	撇,竖,横,横折,横,横,撇,横折钩,点2,点,点,点
舅	撇,竖,横,横折,横,横,竖,横折,横,竖,横,横折钩,撇
舆	撇,竖,横,横,横,撇折,横,竖,横折,横,横,横,撇,点
舌	撇,横,竖,竖,横折,横
舍	撇,捺,横,横,竖,竖,横折,横
舐	撇,横,竖,竖,横折,横,撇,竖提,横,斜钩|卧钩
舒	撇,点,横,横,竖,竖,横折,横,横撇|横钩,点,横撇|横钩,竖钩
舔	撇,横,竖,竖,横折,横,横,横,撇,捺,竖钩,点2,点,点
舛	撇,横撇|横钩,点,横,撇折,竖
舜	撇,点,点,撇,点2,横撇|横钩,撇,横撇|横钩,点,横,撇折,竖
舞	撇,横,横,竖,竖,竖,竖,横,撇,横撇|横钩,点,横,撇折,竖
舟	撇,撇,横折钩,点,横,点
舠	
舢	撇,撇,横折钩,点,横,点,竖,竖弯,竖
舣	撇,撇,横折钩,点,横,点,点,撇,捺
舥	
航	撇,撇,横折钩,点,横,点,点,横,撇,横斜钩
舫	撇,撇,横折钩,点,横,点,点,横,横折钩,撇
般	撇,撇,横折钩,点,横,点,撇,横折折|横折弯,横撇|横钩,捺
舭	撇,撇,横折钩,点,横,点,横,竖提,撇,竖弯钩
舯	撇,撇,横折钩,点,横,点,竖,横折,横,竖
舰	撇,撇,横折钩,点,横,点,竖,横折,撇,竖弯钩
舱	撇,撇,横折钩,点,横,点,撇,捺,横折钩,竖弯钩
舲	
舳	撇,撇,横折钩,点,横,点,竖,横折,横,竖,横
舴	撇,撇,横折钩,点,横,点,撇,横,竖,横,横
舵	撇,撇,横折钩,点,横,点,点,点2,横撇|横钩,撇,竖弯钩
舶	撇,撇,横折钩,点,横,点,撇,竖,横折,横,横
舷	撇,撇,横折钩,点,横,点,点,横,撇折,撇折,点
舸	撇,撇,横折钩,点,横,点,横,竖,横折,横,竖钩
船	撇,撇,横折钩,点,横,点,撇,横折折|横折弯,竖,横折,横
舻	撇,撇,横折钩,点,横,点,竖,横,横折,横,撇
舾	撇,撇,横折钩,点,横,点,横,竖,横折,撇,竖弯,横
艄	撇,撇,横折钩,点,横,点,竖,点,撇,竖,横折钩,横,横
艅	
艇	撇,撇,横折钩,点,横,点,撇,横,竖,横,横折折撇,捺
艉	撇,撇,横折钩,点,横,点,横折,横,撇,撇,横,横,竖弯钩
艋	撇,撇,横折钩,点,横,点,横撇|横钩,竖钩,横,竖,横折,竖,竖,横
艎	
艏	撇,撇,横折钩,点,横,点,点,撇,横,撇,竖,横折,横,横,横
艘	撇,撇,横折钩,点,横,点,撇,竖,横,横折,横,横,竖,横撇|横钩,捺
艚	撇,撇,横折钩,点,横,点,横,竖,横折,横,竖,竖,横,竖,横折,横,横
艟	撇,撇,横折钩,点,横,点,点,横,点,撇,横,竖,横折,横,横,竖,横,横
艨	撇,撇,横折钩,点,横,点,横,竖,竖,点2,横撇|横钩,横,横,撇,弯钩,撇,撇,撇,捺
艮	横折,横,横,竖提,撇,捺
良	点,横折,横,横,竖提,撇,捺
艰	横撇|横钩,点,横折,横,横,竖提,撇,捺
色	撇,横撇|横钩,横折,竖,横,竖弯钩
艳	横,横,横,竖,撇,横撇|横钩,横折,竖,横,竖弯钩
艴	横折,横,竖折折钩,撇,竖,撇,横撇|横钩,横折,竖,横,竖弯钩
艺	横,竖,竖,横斜钩
艽	横,竖,竖,撇,横斜钩
艾	横,竖,竖,撇,捺
艿	横,竖,竖,横折折折钩|横撇弯钩,撇
节	横,竖,竖,横折钩,竖
芃	横,竖,竖,撇,横斜钩,点
芄	横,竖,竖,撇,横斜钩,点
芈	竖,横,竖,横,横,横,竖
芊	横,竖,竖,撇,横,竖
芋	横,竖,竖,横,横,竖钩
芍	横,竖,竖,撇,横折钩,点
芎	横,竖,竖,横折,横,竖折折钩
芏	横,竖,竖,横,竖,横
芑	横,竖,竖,横折,横,竖弯钩
芒	横,竖,竖,点,横,竖弯
芗	横,竖,竖,撇折,撇折,撇
芘	横,竖,竖,横,竖提,撇,竖弯钩
芙	横,竖,竖,横,横,撇,捺
芜	横,竖,竖,横,横,撇,竖弯钩
芝	横,竖,竖,点,横撇|横钩,捺
芟	横,竖,竖,撇,横折折|横折弯,横撇|横钩,捺
芠	
芡	横,竖,竖,撇,横撇|横钩,撇,捺
芣	
芤	横,竖,竖,横撇|横钩,竖钩,提,竖弯钩
芥	横,竖,竖,撇,捺,撇,竖
芦	横,竖,竖,点,横折,横,撇
芨	横,竖,竖,撇,横折折撇,捺
芩	横,竖,竖,撇,捺,点,横撇|横钩
芪	横,竖,竖,撇,竖提,横,斜钩|卧钩
芫	横,竖,竖,横,横,撇,竖弯钩
芬	横,竖,竖,撇,捺,横折钩,撇
芭	横,竖,竖,横折,竖,横,竖弯钩
芮	横,竖,竖,竖,横折钩,撇,点
芯	横,竖,竖,点2,斜钩|卧钩,点,点
芰	横,竖,竖,横,竖,横撇|横钩,捺
花	横,竖,竖,撇,竖,撇,竖弯钩
芳	横,竖,竖,点,横,横折钩,撇
芴	横,竖,竖,撇,横折钩,撇,撇
芷	横,竖,竖,竖,横,竖,横
芸	横,竖,竖,横,横,撇折,点
芹	横,竖,竖,撇,撇,横,竖
芼	
芽	横,竖,竖,横,撇折,竖钩,撇
芾	横,竖,竖,横,竖,横折钩,竖
苁	横,竖,竖,撇,点,撇,捺
苄	横,竖,竖,点,横,竖,点
苇	横,竖,竖,横,横,横折钩,竖
苈	横,竖,竖,横,撇,横折钩,撇
苉	
苊	横,竖,竖,横,撇,横折钩,竖弯钩
苋	横,竖,竖,竖,横折,撇,竖弯钩
苌	横,竖,竖,撇,横,竖提,捺
苍	横,竖,竖,撇,捺,横折钩,竖弯钩
苎	横,竖,竖,点,点2,横撇|横钩,横
苏	横,竖,竖,横折钩,撇,点2,点
苑	横,竖,竖,撇,横撇|横钩,点,横折钩,竖弯钩
苒	横,竖,竖,竖,横折钩,竖,横,横
苓	横,竖,竖,撇,捺,点,横撇|横钩,点
苔	横,竖,竖,撇折,点,竖,横折,横
苕	横,竖,竖,横折钩,撇,竖,横折,横
苗	横,竖,竖,竖,横折,横,竖,横
苘	横,竖,竖,竖,横折钩,竖,横折,横
苛	横,竖,竖,横,竖,横折,横,竖钩
苜	横,竖,竖,竖,横折,横,横,横
苞	横,竖,竖,撇,横折钩,横折,横,竖弯钩
苟	横,竖,竖,撇,横折钩,竖,横折,横
苠	横,竖,竖,横折,横,竖提,横,斜钩|卧钩
苡	横,竖,竖,竖提,点,撇,点
苣	横,竖,竖,横,横折,横,竖弯
苤	横,竖,竖,横,撇,竖,点,横
若	横,竖,竖,横,撇,竖,横折,横
苦	横,竖,竖,横,竖,竖,横折,横
苧	横,竖,竖,点,点2,横撇|横钩,横,竖钩
苫	横,竖,竖,竖,横,竖,横折,横
苯	横,竖,竖,横,竖,撇,捺,横
英	横,竖,竖,竖,横折,横,撇,捺
苴	横,竖,竖,竖,横折,横,横,横
苷	横,竖,竖,横,竖,竖,横,横
苹	横,竖,竖,横,点,撇,横,竖
苻	横,竖,竖,撇,竖,横,竖钩,点
苾	
茀	
茁	横,竖,竖,竖弯,竖,竖,竖弯,竖
茂	横,竖,竖,横,撇,斜钩|卧钩,撇,点
范	横,竖,竖,点,点,提,横折钩,竖弯钩
茄	横,竖,竖,横折钩,撇,竖,横折,横
茅	横,竖,竖,横撇|横钩,点,横撇|横钩,竖钩,撇
茆	横,竖,竖,撇,竖提,撇,横折钩,竖
茈	横,竖,竖,竖,横,竖,提,撇,竖弯钩
茉	横,竖,竖,横,横,竖,撇,捺
茋	
茌	横,竖,竖,撇,竖,横,竖,横
茎	横,竖,竖,横撇|横钩,点,横,竖,横
茏	横,竖,竖,横,撇,竖弯钩,撇,点
茑	横,竖,竖,撇,横折钩,点,竖折折钩,横
茓	
茔	横,竖,竖,点2,横撇|横钩,横,竖,横
茕	横,竖,竖,点2,横撇|横钩,横斜钩,横,竖
茗	横,竖,竖,撇,横撇|横钩,点,竖,横折,横
茚	横,竖,竖,撇,竖提,横,横折钩,竖
茛	横,竖,竖,横折,横,横,竖提,撇,捺
茜	横,竖,竖,横,竖,横折,撇,竖弯,横
茝	
茧	横,竖,竖,竖,横折,横,竖,横,点
茨	横,竖,竖,点,提,撇,横撇|横钩,撇,捺
茫	横,竖,竖,点,点,提,点,横,竖弯
茬	横,竖,竖,横,撇,竖,横,竖,横
茭	横,竖,竖,点,横,撇,点,撇,捺
茯	横,竖,竖,撇,竖,横,撇,捺,点
茱	横,竖,竖,撇,横,横,竖,撇,捺
茳	横,竖,竖,点,点,提,横,竖,横
茴	横,竖,竖,竖,横折,竖,横折,横,横
茵	横,竖,竖,竖,横折,横,撇,点,横
茶	横,竖,竖,撇,捺,横,竖钩,撇,点
茸	横,竖,竖,横,竖,竖,横,横,横
茹	横,竖,竖,撇点,撇,横,竖,横折,横
茺	横,竖,竖,点,横,撇折,点,撇,竖弯钩
茼	横,竖,竖,竖,横折钩,横,竖,横折,横
茽	
荀	横,竖,竖,撇,横折钩,竖,横折,横,横
荁	
荃	横,竖,竖,撇,捺,横,横,竖,横
荄	
荆	横,竖,竖,横,横,撇,竖,竖,竖钩
荇	横,竖,竖,撇,撇,竖,横,横,竖钩
草	横,竖,竖,竖,横折,横,横,横,竖
荏	横,竖,竖,撇,竖,撇,横,竖,横
荐	横,竖,竖,横,撇,竖,横撇|横钩,竖钩,横
荑	横,竖,竖,横,横折,横,竖折折钩,撇,捺
荒	横,竖,竖,点,横,竖弯,撇,竖,竖弯钩
荓	
荔	横,竖,竖,横折钩,撇,横折钩,撇,横折钩,撇
荖	
荙	
荚	横,竖,竖,横,点,撇,横,撇,捺
荛	横,竖,竖,横,斜钩|卧钩,撇,横,撇,竖弯钩
荜	横,竖,竖,横,竖提,撇,竖弯钩,横,竖
荞	横,竖,竖,撇,横,撇,捺,撇,竖
荟	横,竖,竖,撇,捺,横,横,撇折,点
荠	横,竖,竖,点,横,撇,捺,撇,竖
荡	横,竖,竖,点,点,提,横折折折钩|横撇弯钩,撇,撇
荣	横,竖,竖,点2,横撇|横钩,横,竖,撇,捺
荤	横,竖,竖,点2,横撇|横钩,横,撇折,横,竖
荥	横,竖,竖,点2,横撇|横钩,竖钩,横撇|横钩,撇,捺
荦	横,竖,竖,点2,横撇|横钩,撇,横,横,竖
荧	横,竖,竖,点2,横撇|横钩,点2,撇,撇,捺
荨	横,竖,竖,横折,横,横,横,竖钩,点
荩	横,竖,竖,横折,横,撇,捺,点,点
荪	横,竖,竖,横撇|横钩,竖钩,提,竖钩,撇,点
荫	横,竖,竖,横折折折钩|横撇弯钩,竖,撇,横折钩,横,横
荬	横,竖,竖,横撇|横钩,点,点,横,撇,点
荭	横,竖,竖,撇折,撇折,提,横,竖,横
荮	横,竖,竖,撇折,撇折,提,横,竖钩,点
药	横,竖,竖,撇折,撇折,提,撇,横折钩,点
荷	横,竖,竖,撇,竖,横,竖,横折,横,竖钩
荸	横,竖,竖,横,竖,点2,横撇|横钩,横撇|横钩,竖钩,横
荻	横,竖,竖,撇,弯钩,撇,点2,撇,撇,捺
荼	横,竖,竖,撇,捺,横,横,竖钩,撇,点
荽	横,竖,竖,撇,点,点,撇,撇点,撇,横
莅	横,竖,竖,撇,竖,点,横,点,撇,横
莆	横,竖,竖,横,竖,横折钩,横,横,竖,点
莉	横,竖,竖,撇,横,竖,撇,点,竖,竖钩
莎	横,竖,竖,点,点,提,竖,撇,点,撇
莒	横,竖,竖,竖,横折,横,竖,横折,横
莓	横,竖,竖,撇,横,竖弯,横折钩,点,横,点
莘	横,竖,竖,点,横,点,撇,横,横,竖
莙	
莛	横,竖,竖,撇,横,竖,横,横折折撇,捺
莜	横,竖,竖,撇,竖,竖,撇,横,撇,捺
莝	
莞	横,竖,竖,点,点2,横撇|横钩,横,横,撇,竖弯钩
莠	横,竖,竖,撇,横,竖,撇,捺,横折折折钩|横撇弯钩,撇
莨	横,竖,竖,点,横折,横,横,竖提,撇,捺
莩	横,竖,竖,撇,点,点,撇,横撇|横钩,竖钩,横
莪	横,竖,竖,撇,横,竖钩,提,斜钩|卧钩,撇,点
莫	横,竖,竖,竖,横折,横,横,横,撇,捺
莰	横,竖,竖,横,竖,提,撇,横撇|横钩,撇,捺
莱	横,竖,竖,横,点,撇,横,竖,撇,捺
莲	横,竖,竖,横,撇折,横,竖,点,横折折撇,捺
莳	横,竖,竖,竖,横折,横,横,横,竖钩,点
莴	横,竖,竖,竖,横折,横,竖,横折钩,撇,点
莶	横,竖,竖,撇,捺,横,点,点,撇,横
获	横,竖,竖,撇,弯钩,撇,横,撇,捺,点
莸	横,竖,竖,撇,弯钩,撇,横,撇,竖弯钩,点
莹	横,竖,竖,点2,横撇|横钩,横,横,竖,横,点
莺	横,竖,竖,点2,横撇|横钩,撇,横折钩,点,竖折折钩,横
莼	横,竖,竖,撇折,撇折,提,横,竖弯,竖,竖弯钩
莽	横,竖,竖,横,撇,捺,点,横,撇,竖
莿	
菀	横,竖,竖,点,点2,横撇|横钩,撇,横撇|横钩,点,横折钩,竖弯钩
菁	横,竖,竖,横,横,竖,横,竖,横折钩,横,横
菂	横,竖,竖,撇,竖,横折,横,横,撇,横折钩,点
菅	横,竖,竖,点,点2,横撇|横钩,竖,横折,横,横折,横
菇	横,竖,竖,撇点,撇,横,横,竖,竖,横折,横
菉	
菊	横,竖,竖,撇,横折钩,点,撇,横,竖,撇,点
菌	横,竖,竖,竖,横折,撇,横,竖,撇,点,横
菍	
菏	横,竖,竖,点,点,提,横,竖,横折,横,竖钩
菔	横,竖,竖,撇,横折钩,横,横,横折钩,竖,横撇|横钩,捺
菖	横,竖,竖,竖,横折,横,横,竖,横折,横,横
菘	横,竖,竖,横,竖,撇,点,撇,捺,撇折,点
菜	横,竖,竖,撇,点,点,撇,横,竖,撇,捺
菝	横,竖,竖,横,竖钩,提,横,撇,横撇|横钩,捺,点
菟	横,竖,竖,撇,横撇|横钩,竖,横折,横,撇,竖弯钩,点
菠	横,竖,竖,点,点,提,横撇|横钩,撇,竖,横撇|横钩,捺
菡	横,竖,竖,横撇|横钩,竖钩,点,提,撇,点,竖弯,竖
菥	横,竖,竖,横,竖,撇,点,撇,撇,横,竖
菩	横,竖,竖,点,横,点,撇,横,竖,横折,横
菪	横,竖,竖,点,点2,横撇|横钩,横,撇,竖,横折,横
菰	横,竖,竖,横撇|横钩,竖钩,提,撇,撇,竖提,点,捺
菱	横,竖,竖,横,竖,横,撇,点,撇,横撇|横钩,捺
菲	横,竖,竖,竖,横,横,横,竖,横,横,横
菹	横,竖,竖,点,点,提,竖,横折,横,横,横
菼	
菽	横,竖,竖,竖,横,横,竖钩,撇,点,横撇|横钩,捺
萁	横,竖,竖,横,竖,竖,横,横,横,撇,点
萃	横,竖,竖,点,横,撇,点,撇,点,横,竖
萄	横,竖,竖,撇,横折钩,撇,横,横,竖,竖弯,竖
萆	横,竖,竖,撇,竖,横折,横,横,撇,横,竖
萋	横,竖,竖,横,横折,横,横,竖,撇点,撇,横
萌	横,竖,竖,竖,横折,横,横,撇,横折钩,横,横
萍	横,竖,竖,点,点,提,横,点,撇,横,竖
萎	横,竖,竖,撇,横,竖,撇,捺,撇点,撇,横
萏	横,竖,竖,撇,横撇|横钩,撇,竖,横,横折,横,横
萑	横,竖,竖,撇,竖,点,横,横,横,竖,横
萘	横,竖,竖,横,撇,捺,横,横,竖钩,撇,点
萚	
萜	横,竖,竖,竖,横折钩,竖,竖,横,竖,横折,横
萝	横,竖,竖,竖,横折,竖,竖,横,撇,横撇|横钩,点
萣	
萤	横,竖,竖,点2,横撇|横钩,竖,横折,横,竖,横,点
营	横,竖,竖,点2,横撇|横钩,竖,横折,横,竖,横折,横
萦	横,竖,竖,点2,横撇|横钩,撇折,撇折,点,竖钩,撇,点
萧	横,竖,竖,横折,横,横,竖,撇,竖,撇,点
萨	横,竖,竖,横折折折钩|横撇弯钩,竖,点,横,点,撇,横,撇
萩	横,竖,竖,撇,横,竖,撇,点,点2,撇,撇,捺
萱	横,竖,竖,点,点2,横撇|横钩,横,竖,横折,横,横,横
萳	
萸	横,竖,竖,撇,竖,横,横折,横,横,撇,捺
萹	
萼	横,竖,竖,竖,横折,横,竖,横折,横,横,横,竖折折钩
落	横,竖,竖,点,点,提,撇,横撇|横钩,捺,竖,横折,横
葆	横,竖,竖,撇,竖,竖,横折,横,横,竖,撇,捺
葎	
葑	横,竖,竖,横,竖,横,横,竖,提,横,竖钩,点
葖	
著	横,竖,竖,横,竖,横,撇,竖,横折,横,横
葙	横,竖,竖,横,竖,撇,点,竖,横折,横,横,横
葚	横,竖,竖,横,竖,竖,横,横,横,撇,点,竖弯
葛	横,竖,竖,竖,横折,横,横,撇,横折钩,撇,点,竖弯
葜	横,竖,竖,横,横,横,竖,横折钩,撇,横,撇,捺
葡	横,竖,竖,撇,横折钩,横,竖,横折钩,横,横,竖,点
董	横,竖,竖,撇,横,竖,横折,横,横,竖,横,横
葩	横,竖,竖,撇,竖,横折,横,横,横折,竖,横,竖弯钩
葫	横,竖,竖,横,竖,竖,横折,横,撇,横折钩,横,横
葬	横,竖,竖,横,撇,横撇|横钩,点,撇,竖弯钩,横,撇,竖
葭	横,竖,竖,横折,横,竖,横,横,横折,横,横撇|横钩,捺
葰	
葱	横,竖,竖,撇,横折钩,撇,撇,点,点2,斜钩|卧钩,点,点
葳	横,竖,竖,横,撇,横,撇点,撇,横,斜钩|卧钩,撇,点
葴	
葵	横,竖,竖,横撇|横钩,点,撇,撇,捺,横,横,撇,点
葶	横,竖,竖,点,横,竖,横折,横,点2,横撇|横钩,横,竖钩
葸	横,竖,竖,竖,横折,横,竖,横,点2,斜钩|卧钩,点,点
葺	横,竖,竖,竖,横折,横,横,竖,竖,横,横,横
蒂	横,竖,竖,点,横,点,撇,点2,横撇|横钩,竖,横折钩,竖
蒄	
蒇	横,竖,竖,横,撇,竖,横折,撇,点,斜钩|卧钩,撇,点
蒈	横,竖,竖,横,竖提,撇,竖弯钩,撇,竖,横折,横,横
蒉	横,竖,竖,竖,横折,横,竖,横,竖,横折,撇,点
蒋	横,竖,竖,点,提,竖,撇,横撇|横钩,点,横,竖钩,点
蒌	横,竖,竖,点,撇,横,竖,撇,捺,撇点,撇,横
蒎	横,竖,竖,点,点,提,撇,撇,撇,竖提,撇,捺
蒐	横,竖,竖,撇,竖,横折,横,横,撇,竖弯钩,撇折,点
蒗	横,竖,竖,点,点,提,点,横折,横,横,竖提,撇,捺
蒙	横,竖,竖,点2,横撇|横钩,横,横,撇,弯钩,撇,撇,撇,捺
蒜	横,竖,竖,横,横,竖钩,撇,点,横,横,竖钩,撇,点
蒟	
蒡	横,竖,竖,点,横,点,撇,点2,横撇|横钩,点,横,横折钩,撇
蒨	
蒯	横,竖,竖,撇,横折钩,横,横,撇,横折钩,横,横,竖,竖钩
蒱	
蒲	横,竖,竖,点,点,提,横,竖,横折钩,横,横,竖,点
蒴	横,竖,竖,点,撇,横,竖弯,竖,撇,撇,横折钩,横,横
蒸	横,竖,竖,横撇|横钩,竖钩,横撇|横钩,撇,捺,横,点2,点,点,点
蒹	横,竖,竖,点,撇,横,横折,横,横,竖,竖,撇,捺
蒺	横,竖,竖,点,横,撇,点,提,撇,横,横,撇,捺
蒻	
蒽	横,竖,竖,竖,横折,横,撇,点,横,点2,斜钩|卧钩,点,点
蒿	横,竖,竖,点,横,竖,横折,横,竖,横折钩,竖,横折,横
蓁	横,竖,竖,横,横,横,撇,捺,撇,横,竖,撇,点
蓂	
蓄	横,竖,竖,点,横,撇折,撇折,点,竖,横折,横,竖,横
蓇	
蓉	横,竖,竖,点,点2,横撇|横钩,撇,点,撇,捺,竖,横折,横
蓊	横,竖,竖,撇,捺,撇折,点,横折钩,点,提,横折钩,点,提
蓍	横,竖,竖,横,竖,横,撇,撇,竖弯钩,竖,横折,横,横
蓏	
蓐	横,竖,竖,横,撇,横,横,竖提,撇,捺,横,竖钩,点
蓑	横,竖,竖,点,横,竖,横折,横,横,撇,竖提,撇,捺
蓓	横,竖,竖,撇,竖,点,横,点,撇,横,竖,横折,横
蓖	横,竖,竖,撇,竖,横折,撇,点,横,横,竖提,撇,竖弯钩
蓝	横,竖,竖,竖,竖,撇,横,点,竖,横折,竖,竖,横
蓟	横,竖,竖,撇,横撇|横钩,竖,横折,横,竖,横,提,竖,竖钩
蓠	横,竖,竖,点,横,撇,点,竖弯,竖,竖,横折钩,撇折,点
蓢	横,竖,竖,点,横折,横,横,竖提,点,撇,横折钩,横,横
蓣	横,竖,竖,横撇|横钩,点,横撇|横钩,竖钩,横,撇,竖,横折,撇,点
蓥	横,竖,竖,点2,横撇|横钩,撇,捺,横,横,竖,点,撇,横
蓦	横,竖,竖,竖,横折,横,横,横,撇,捺,横折,竖折折钩,横
蓬	横,竖,竖,撇,横撇|横钩,捺,横,横,横,竖,点,横折折撇,捺
蓰	横,竖,竖,撇,撇,竖,竖,横,竖,横,竖,横,撇,捺
蓼	横,竖,竖,横折,点,提,横折,点,提,撇,捺,撇,撇,撇
蓿	横,竖,竖,点,点2,横撇|横钩,撇,竖,横,撇,竖,横折,横,横
蔀	
蔃	
蔈	
蔊	
蔌	横,竖,竖,横,竖,横折,横,竖,撇,点,撇,横撇|横钩,撇,捺
蔑	横,竖,竖,竖,横折,竖,竖,横,横,撇,点,斜钩|卧钩,撇,点
蔓	横,竖,竖,竖,横折,横,横,竖,横折,竖,竖,横,横撇|横钩,捺
蔗	横,竖,竖,点,横,撇,横,竖,竖,横,点2,点,点,点
蔚	横,竖,竖,横折,横,撇,横,横,竖钩,撇,点,横,竖钩,点
蔟	横,竖,竖,点,横,横折钩,撇,撇,横,撇,横,横,撇,捺
蔡	横,竖,竖,撇,横撇|横钩,点,点,横撇|横钩,捺,横,横,竖钩,撇,点
蔫	横,竖,竖,横,竖,横,竖,横,横,竖折折钩,点2,点,点,点
蔬	横,竖,竖,横撇|横钩,竖,横,竖,提,点,横,撇折,点,撇,竖,竖弯钩
蔷	横,竖,竖,横,竖,点,撇,横,竖,横折,竖,横折,横,横
蔸	横,竖,竖,撇,竖,横折,横,横,撇,竖提,横折,横,撇,竖弯钩
蔹	横,竖,竖,撇,捺,横,点,点,撇,提,撇,横,撇,捺
蔺	横,竖,竖,点,竖,横折钩,撇,竖,点,横,横,横,竖,横
蔻	横,竖,竖,点,点2,横撇|横钩,横,横,撇,竖弯钩,竖,横,横撇|横钩,点
蔼	横,竖,竖,点,横折提,竖,横折,横,横,撇,横折钩,撇,点,竖弯
蔽	横,竖,竖,点,撇,竖,横折钩,竖,撇,点,撇,横,撇,捺
蕃	横,竖,竖,撇,点,撇,横,竖,撇,捺,竖,横折,横,竖,横
蕈	横,竖,竖,横,竖,横折,竖,竖,横,竖,横折,横,横,横,竖
蕉	横,竖,竖,撇,竖,点,横,横,横,竖,横,点2,点,点,点
蕊	横,竖,竖,点2,斜钩|卧钩,点,点,点2,斜钩|卧钩,点,点,点2,斜钩|卧钩,点,点
蕖	横,竖,竖,点,点,提,横,横折,横,竖弯,横,竖,撇,捺
蕗	横,竖,竖,竖,横折,横,竖,横,竖,提,撇,横撇|横钩,捺,竖,横折,横
蕙	横,竖,竖,横,竖,横折,横,横,竖,横,点,点2,斜钩|卧钩,点,点
蕞	横,竖,竖,竖,横折,横,横,横,竖,竖,横,横,提,横撇|横钩,捺
蕤	横,竖,竖,横,撇,弯钩,撇,撇,撇,捺,撇,横,横,竖,横
蕨	横,竖,竖,横,撇,点,撇,横,竖弯,竖,撇,撇,横撇|横钩,撇,捺
蕰	
蕲	横,竖,竖,点,撇,竖,横折,横,横,横,竖,撇,撇,横,竖
蕴	横,竖,竖,撇折,撇折,提,竖,横折,横,横,竖,横折,竖,竖,横
蕹	横,竖,竖,点,横,撇折,撇折,撇,撇,竖,点,横,横,横,竖,横
蕺	横,竖,竖,竖,横折,横,横,竖,竖,横,横,提,斜钩|卧钩,撇,点
蕻	横,竖,竖,横,竖,横,横,横,撇折,点,横,竖,竖,横,撇,点
蕾	横,竖,竖,横,点2,横撇|横钩,竖,点,点,点,点,竖,横折,横,竖,横
薁	
薄	横,竖,竖,点,点,提,横,竖,横折,横,横,竖,点,横,竖钩,点
薅	横,竖,竖,撇点,撇,横,横,撇,横,横,竖提,撇,捺,横,竖钩,点
薇	横,竖,竖,撇,撇,竖,竖,竖弯,竖,横,撇,横折提,撇,横,撇,捺
薏	横,竖,竖,点,横,点,撇,横,竖,横折,横,横,点2,斜钩|卧钩,点,点
薛	横,竖,竖,撇,竖,横折,横,横折,横,点,横,点,撇,横,横,竖
薜	横,竖,竖,横折,横,撇,竖,横折,横,点,横,点,撇,横,横,竖
薢	
薤	横,竖,竖,横,撇,横撇|横钩,点,竖,横,横,横,竖,横,横,横,横
薨	横,竖,竖,竖,横折,竖,竖,横,点2,横撇|横钩,横,撇,横撇|横钩,点,撇,竖弯钩
薪	横,竖,竖,点,横,点,撇,横,横,竖钩,撇,点,撇,撇,横,竖
薮	横,竖,竖,点,撇,横,竖,撇,点,撇点,撇,横,撇,横,撇,捺
薯	横,竖,竖,竖,横折,竖,竖,横,横,竖,横,撇,竖,横折,横,横
薰	横,竖,竖,撇,横,竖,横折,点,撇,横,竖,横,横,点2,点,点,点
薳	
薷	横,竖,竖,横,点2,横撇|横钩,竖,点,点,点,点,横,撇,竖,横折钩,竖,竖
薸	
薹	横,竖,竖,横,竖,横,竖,横折,横,点2,横撇|横钩,横,撇折,点,横,竖,横
薿	
藁	横,竖,竖,点,横,竖,横折,横,竖,横折钩,竖,横折,横,横,竖,撇,捺
藉	横,竖,竖,横,横,横,竖,撇,点,横,竖,竖,横,竖,横折,横,横
藏	横,竖,竖,横,撇,竖弯,横,撇,横,竖,横折,横,竖,竖弯,斜钩|卧钩,撇,点
藐	横,竖,竖,撇,点,点,撇,弯钩,撇,撇,撇,竖,横折,横,横,撇,竖弯钩
藓	横,竖,竖,撇,横撇|横钩,竖,横折,横,竖,横,提,点,撇,横,横,横,竖
藕	横,竖,竖,横,横,横,竖,撇,点,竖,横折,横,横,竖,横折钩,竖,提,点
藜	横,竖,竖,撇,横,竖,撇,点,撇,横折钩,撇,撇,捺,竖钩,点,提,撇,点
藟	
藠	横,竖,竖,撇,竖,横折,横,横,撇,竖,横折,横,横,撇,竖,横折,横,横
藤	横,竖,竖,撇,横折钩,横,横,点,撇,横,横,撇,捺,竖钩,点,提,撇,点
藦	
藨	
藩	横,竖,竖,点,点,提,撇,点,撇,横,竖,撇,捺,竖,横折,横,竖,横
藻	横,竖,竖,点,点,提,竖,横折,横,竖,横折,横,竖,横折,横,横,竖,撇,捺
藿	横,竖,竖,横,点2,横撇|横钩,竖,点,点,点,点,撇,竖,点,横,横,横,竖,横
蘅	横,竖,竖,撇,撇,竖,撇,横撇|横钩,竖,横折,横,竖,横,横,撇,点,横,横,竖钩
蘑	横,竖,竖,点,横,撇,横,竖,撇,点,横,竖,撇,捺,横,撇,竖,横折,横
蘖	横,竖,竖,撇,竖,横折,横,横折,横,点,横,点,撇,横,横,竖,横,竖,撇,捺
蘘	
蘧	横,竖,竖,竖,横,横撇|横钩,撇,横,竖弯钩,横,撇,弯钩,撇,撇,撇,点,点,横折折撇,捺
蘩	横,竖,竖,撇,横,竖弯,横折,点,横,点,撇,横,撇,捺,撇折,撇折,点,竖钩,撇,点
蘸	横,竖,竖,横,竖,横折,撇,竖弯,横,横,撇,竖,点,横,横,横,竖,横,点2,点,点,点
蘼	横,竖,竖,点,横,撇,横,竖,撇,点,横,竖,撇,捺,竖,横,横,横,竖,横,横,横
虎	竖,横,横撇|横钩,撇,横,竖弯钩,撇,横斜钩
虏	竖,横,横撇|横钩,撇,横,竖弯钩,横折钩,撇
虐	竖,横,横撇|横钩,撇,横,竖弯钩,横,竖弯,横
虑	竖,横,横撇|横钩,撇,横,竖弯钩,点2,斜钩|卧钩,点,点
虒	
虓	
虔	竖,横,横撇|横钩,撇,横,竖弯钩,点,横,撇,捺
虚	竖,横,横撇|横钩,撇,横,竖弯钩,竖,竖,点,撇,横
虞	竖,横,横撇|横钩,撇,横,竖弯钩,竖,横折,横,横,横,撇,捺
虢	撇,点,点,撇,横,竖钩,点,竖,横,横撇|横钩,撇,横,竖弯钩,撇,横斜钩
虤	
虫	竖,横折,横,竖,横,点
虬	竖,横折,横,竖,横,点,竖弯钩
虮	竖,横折,横,竖,横,点,撇,横斜钩
虱	横斜钩,撇,竖,横折,横,竖,横,点
虷	
虸	
虹	竖,横折,横,竖,横,点,横,竖,横
虺	横,撇,竖弯钩,竖,横折,横,竖,横,点
虻	竖,横折,横,竖,横,点,点,横,竖弯
虼	竖,横折,横,竖,横,点,撇,横,横斜钩
虽	竖,横折,横,竖,横折,横,竖,横,点
虾	竖,横折,横,竖,横,点,横,竖,点
虿	横,横折钩,撇,竖,横折,横,竖,横,点
蚀	撇,横撇|横钩,竖提,竖,横折,横,竖,横,点
蚁	竖,横折,横,竖,横,点,点,撇,捺
蚂	竖,横折,横,竖,横,点,横折,竖折折钩,横
蚄	
蚆	
蚊	竖,横折,横,竖,横,点,点,横,撇,捺
蚋	竖,横折,横,竖,横,点,竖,横折钩,撇,点
蚌	竖,横折,横,竖,横,点,横,横,横,竖
蚍	竖,横折,横,竖,横,点,横,竖提,撇,竖弯钩
蚓	竖,横折,横,竖,横,点,横折,横,竖折折钩,竖
蚕	横,横,撇,捺,竖,横折,横,竖,横,点
蚜	竖,横折,横,竖,横,点,横,撇折,竖钩,撇
蚝	竖,横折,横,竖,横,点,撇,横,横,竖弯钩
蚣	竖,横折,横,竖,横,点,撇,捺,撇折,点
蚤	横撇|横钩,捺,点,竖,横折,横,竖,横,点
蚧	竖,横折,横,竖,横,点,撇,捺,撇,竖
蚨	竖,横折,横,竖,横,点,横,横,撇,捺
蚩	竖弯,竖,竖,横,竖,横折,横,竖,横,点
蚪	竖,横折,横,竖,横,点,点,点,横,竖
蚬	竖,横折,横,竖,横,点,竖,横折,撇,竖弯钩
蚯	竖,横折,横,竖,横,点,撇,竖,横,竖,横
蚰	竖,横折,横,竖,横,点,竖,横折,横,竖,横
蚱	竖,横折,横,竖,横,点,撇,横,竖,横,横
蚲	
蚴	竖,横折,横,竖,横,点,撇折,撇折,点,横折钩,撇
蚶	竖,横折,横,竖,横,点,横,竖,竖,横,横
蚺	竖,横折,横,竖,横,点,竖,横折钩,竖,横,横
蛀	竖,横折,横,竖,横,点,点,横,横,竖,横
蛃	
蛄	竖,横折,横,竖,横,点,横,竖,竖,横折,横
蛆	竖,横折,横,竖,横,点,竖,横折,横,横,横
蛇	竖,横折,横,竖,横,点,点,点2,横撇|横钩,撇,竖弯钩
蛉	竖,横折,横,竖,横,点,撇,捺,点,横撇|横钩,点
蛊	竖,横折,横,竖,横,点,竖,横折,竖,竖,横
蛋	横撇|横钩,竖,横,撇,捺,竖,横折,横,竖,横,点
蛎	竖,横折,横,竖,横,点,横,撇,横,横折钩,撇
蛏	竖,横折,横,竖,横,点,横撇|横钩,捺,横,竖,横
蛐	竖,横折,横,竖,横,点,竖,横折,横,竖,竖,横
蛑	竖,横折,横,竖,横,点,撇折,点,撇,横,横,竖
蛔	竖,横折,横,竖,横,点,竖,横折,竖,横折,横,横
蛘	竖,横折,横,竖,横,点,点,撇,横,横,横,竖
蛙	竖,横折,横,竖,横,点,横,竖,横,横,竖,横
蛛	竖,横折,横,竖,横,点,撇,横,横,竖,撇,捺
蛞	竖,横折,横,竖,横,点,撇,横,竖,竖,横折,横
蛟	竖,横折,横,竖,横,点,点,横,撇,点,撇,捺
蛤	竖,横折,横,竖,横,点,撇,捺,横,竖,横折,横
蛩	横,竖,提,撇,横斜钩,点,竖,横折,横,竖,横,点
蛭	竖,横折,横,竖,横,点,横,撇折,点,横,竖,横
蛮	点,横,竖,竖,撇,点,竖,横折,横,竖,横,点
蛰	横,竖钩,提,撇,横斜钩,点,竖,横折,横,竖,横,点
蛱	竖,横折,横,竖,横,点,横,点,撇,横,撇,捺
蛲	竖,横折,横,竖,横,点,横,斜钩|卧钩,撇,横,撇,竖弯钩
蛳	竖,横折,横,竖,横,点,竖,撇,横,竖,横折钩,竖
蛴	竖,横折,横,竖,横,点,点,横,撇,捺,撇,竖
蛸	竖,横折,横,竖,横,点,竖,点,撇,竖,横折钩,横,横
蛹	竖,横折,横,竖,横,点,横撇|横钩,点,竖,横折钩,横,横,竖
蛾	竖,横折,横,竖,横,点,撇,横,竖钩,提,斜钩|卧钩,撇,点
蜀	竖,横折,竖,竖,横,撇,横折钩,竖,横折,横,竖,横,点
蜂	竖,横折,横,竖,横,点,撇,横撇|横钩,捺,横,横,横,竖
蜃	横,撇,横,横,竖提,撇,捺,竖,横折,横,竖,横,点
蜇	横,竖钩,提,撇,撇,横,竖,竖,横折,横,竖,横,点
蜈	竖,横折,横,竖,横,点,竖,横折,横,横,横,撇,捺
蜉	竖,横折,横,竖,横,点,撇,点,点,撇,横撇|横钩,竖钩,横
蜊	竖,横折,横,竖,横,点,撇,横,竖,撇,点,竖,竖钩
蜍	竖,横折,横,竖,横,点,撇,捺,横,横,竖钩,撇,点
蜎	
蜐	
蜒	竖,横折,横,竖,横,点,撇,竖,横,竖弯,横折折撇,捺
蜓	竖,横折,横,竖,横,点,撇,横,竖,横,横折折撇,捺
蜕	竖,横折,横,竖,横,点,点,撇,竖,横折,横,撇,竖弯钩
蜗	竖,横折,横,竖,横,点,竖,横折,横,竖,横折钩,撇,点
蜘	竖,横折,横,竖,横,点,撇,横,横,撇,点,竖,横折,横
蜚	竖,横,横,横,竖,横,横,横,竖,横折,横,竖,横,点
蜜	点,点2,横撇|横钩,点2,斜钩|卧钩,点,撇,点,竖,横折,横,竖,横,点
蜞	竖,横折,横,竖,横,点,横,竖,竖,横,横,横,撇,点
蜡	竖,横折,横,竖,横,点,横,竖,竖,横,竖,横折,横,横
蜢	竖,横折,横,竖,横,点,横撇|横钩,竖钩,横,竖,横折,竖,竖,横
蜣	竖,横折,横,竖,横,点,点,撇,横,横,横,撇,竖弯钩
蜥	竖,横折,横,竖,横,点,横,竖,撇,点,撇,撇,横,竖
蜩	竖,横折,横,竖,横,点,撇,横折钩,横,竖,横,竖,横折,横
蜮	竖,横折,横,竖,横,点,横,竖,横折,横,提,斜钩|卧钩,撇,点
蜱	竖,横折,横,竖,横,点,撇,竖,横折,横,横,撇,横,竖
蜴	竖,横折,横,竖,横,点,竖,横折,横,横,撇,横折钩,撇,撇
蜷	竖,横折,横,竖,横,点,点,撇,横,横,撇,捺,横折钩,竖弯钩
蜻	竖,横折,横,竖,横,点,横,横,竖,横,竖,横折钩,横,横
蜾	竖,横折,横,竖,横,点,竖,横折,横,横,横,竖,撇,捺
蜿	竖,横折,横,竖,横,点,点,点2,横撇|横钩,撇,横撇|横钩,点,横折钩,竖弯钩
蝇	竖,横折,横,竖,横,点,竖,横折,横,竖,横折,横,横,竖弯钩
蝈	竖,横折,横,竖,横,点,竖,横折,横,横,竖,横,点,横
蝉	竖,横折,横,竖,横,点,点,撇,竖,横折,横,横,横,竖
蝌	竖,横折,横,竖,横,点,撇,横,竖,撇,点,点,点,横,竖
蝎	竖,横折,横,竖,横,点,竖,横折,横,横,撇,横折钩,撇,点,竖弯
蝓	竖,横折,横,竖,横,点,撇,捺,横,竖,横折钩,横,横,竖,竖钩
蝗	竖,横折,横,竖,横,点,撇,竖,横折,横,横,横,横,竖,横
蝘	
蝙	竖,横折,横,竖,横,点,点,横折,横,撇,竖,横折钩,横,竖,竖
蝠	竖,横折,横,竖,横,点,横,竖,横折,横,竖,横折,横,竖,横
蝣	竖,横折,横,竖,横,点,点,横,横折钩,撇,撇,横,横撇|横钩,竖钩,横
蝤	竖,横折,横,竖,横,点,点,撇,横,竖,横折,撇,竖弯,横,横
蝥	横撇|横钩,点,横撇|横钩,竖钩,撇,撇,横,撇,捺,竖,横折,横,竖,横,点
蝮	竖,横折,横,竖,横,点,撇,横,竖,横折,横,横,撇,横撇|横钩,捺
蝰	竖,横折,横,竖,横,点,横,撇,捺,横,竖,横,横,竖,横
蝲	
蝴	竖,横折,横,竖,横,点,横,竖,竖,横折,横,撇,横折钩,横,横
蝶	竖,横折,横,竖,横,点,横,竖,竖,横,竖弯,横,竖,撇,捺
蝻	竖,横折,横,竖,横,点,横,竖,竖,横折钩,点,撇,横,横,竖
蝼	竖,横折,横,竖,横,点,点,撇,横,竖,撇,捺,撇点,撇,横
蝽	竖,横折,横,竖,横,点,横,横,横,撇,捺,竖,横折,横,横
蝾	竖,横折,横,竖,横,点,横,竖,竖,点2,横撇|横钩,横,竖,撇,捺
螂	竖,横折,横,竖,横,点,点,横折,横,横,竖提,点,横折折折钩|横撇弯钩,竖
螃	竖,横折,横,竖,横,点,点,横,点,撇,点2,横撇|横钩,点,横,横折钩,撇
螅	竖,横折,横,竖,横,点,撇,竖,横折,横,横,横,点2,斜钩|卧钩,点,点
螈	竖,横折,横,竖,横,点,横,撇,撇,竖,横折,横,横,竖钩,撇,点
螋	竖,横折,横,竖,横,点,撇,竖,横,横折,横,横,竖,横撇|横钩,捺
融	横,竖,横折,横,竖,横折钩,点,撇,横,竖,竖,横折,横,竖,横,点
螗	竖,横折,横,竖,横,点,点,横,撇,横折,横,横,竖,竖,横折,横
螟	竖,横折,横,竖,横,点,点2,横撇|横钩,竖,横折,横,横,点,横,撇,点
螠	
螣	
螨	竖,横折,横,竖,横,点,横,竖,竖,横,竖,横折钩,撇,点,撇,点
螫	横,竖,横,撇,竖钩,撇,点,撇,横,撇,捺,竖,横折,横,竖,横,点
螬	竖,横折,横,竖,横,点,横,竖,横折,横,竖,竖,横,竖,横折,横,横
螭	竖,横折,横,竖,横,点,点,横,撇,点,竖弯,竖,竖,横折钩,撇折,点
螯	横,横,竖,横,横折钩,撇,撇,横,撇,捺,竖,横折,横,竖,横,点
螱	
螳	竖,横折,横,竖,横,点,竖,点,撇,点2,横撇|横钩,竖,横折,横,横,竖,横
螵	竖,横折,横,竖,横,点,横,竖,横折,竖,竖,横,横,横,竖钩,撇,点
螺	竖,横折,横,竖,横,点,竖,横折,横,竖,横,撇折,撇折,点,竖钩,撇,点
螽	撇,横撇|横钩,捺,点,点,竖,横折,横,竖,横,点,竖,横折,横,竖,横,点
蟀	竖,横折,横,竖,横,点,点,横,撇折,撇折,点,点,提,撇,点,横,竖
蟆	竖,横折,横,竖,横,点,横,竖,竖,竖,横折,横,横,横,撇,捺
蟊	横撇|横钩,点,横撇|横钩,竖钩,撇,竖,横折,横,竖,横,点,竖,横折,横,竖,横,点
蟋	竖,横折,横,竖,横,点,撇,点,撇,横,竖,撇,捺,点2,斜钩|卧钩,点,点
蟏	
蟑	竖,横折,横,竖,横,点,点,横,点,撇,横,竖,横折,横,横,横,竖
蟒	竖,横折,横,竖,横,点,横,竖,竖,横,撇,捺,点,横,撇,竖
蟛	竖,横折,横,竖,横,点,横,竖,横,竖,横折,横,点,撇,提,撇,撇,撇
蟠	竖,横折,横,竖,横,点,撇,点,撇,横,竖,撇,捺,竖,横折,横,竖,横
蟥	竖,横折,横,竖,横,点,横,竖,竖,横,竖,横折,横,竖,横,撇,点
蟪	竖,横折,横,竖,横,点,横,竖,横折,横,横,竖,横,点,点2,斜钩|卧钩,点,点
蟫	
蟮	竖,横折,横,竖,横,点,点,撇,横,横,横,竖,点,撇,横,竖,横折,横
蟹	撇,横撇|横钩,撇,横折钩,横,横,竖,横折钩,撇,撇,横,横,竖,竖,横折,横,竖,横,点
蟾	竖,横折,横,竖,横,点,撇,横撇|横钩,横,撇,撇,点,点,横,横,横,竖,横折,横
蠃	点,横,竖弯,竖,横折,横,撇,横折钩,横,横,竖,横折,横,竖,横,点,撇,横斜钩,点
蠊	竖,横折,横,竖,横,点,点,横,撇,点,撇,横,横折,横,横,竖,竖,撇,捺
蠋	
蠓	竖,横折,横,竖,横,点,横,竖,竖,点2,横撇|横钩,横,横,撇,弯钩,撇,撇,撇,捺
蠕	竖,横折,横,竖,横,点,横,点2,横撇|横钩,竖,点,点,点,点,横,撇,竖,横折钩,竖,竖
蠖	竖,横折,横,竖,横,点,横,竖,竖,撇,竖,点,横,横,横,竖,横,横撇|横钩,捺
蠡	撇折,横撇|横钩,横,撇,弯钩,撇,撇,撇,捺,竖,横折,横,竖,横,点,竖,横折,横,竖,横,点
蠢	横,横,横,撇,捺,竖,横折,横,横,竖,横折,横,竖,横,点,竖,横折,横,竖,横,点
蠲	点,撇,横,撇,点,竖,横折,竖,竖,提,竖,横折,竖,竖,横,撇,横折钩,竖,横折,横,竖,横,点
蠹	横,竖,横折,横,竖,点2,横撇|横钩,横,撇,竖,横折,横,竖,横折,横,竖,横,点,竖,横折,横,竖,横,点
蠼	竖,横折,横,竖,横,点,竖,横折,横,横,横,竖,横折,横,横,横,撇,竖,点,横,横,横,竖,横,横撇|横钩,捺
血	撇,竖,横折,竖,竖,横
衃	
衄	撇,竖,横折,竖,竖,提,横折,竖,横,横
衅	撇,竖,横折,竖,竖,提,点,撇,横,横,竖
行	撇,撇,竖,横,横,竖钩
衍	撇,撇,竖,点,点,提,横,横,竖钩
衎	
衒	
衔	撇,撇,竖,撇,横,横,横,竖提,横,横,竖钩
街	撇,撇,竖,横,竖,横,横,竖,提,横,横,竖钩
衙	撇,撇,竖,横,竖,横折,横,竖,横折,横,横,横,竖钩
衠	
衡	撇,撇,竖,撇,横撇|横钩,竖,横折,横,竖,横,横,撇,点,横,横,竖钩
衢	撇,撇,竖,竖,横折,横,横,横,竖,横折,横,横,横,撇,竖,点,横,横,横,竖,横,横,横,竖钩
衣	点,横,撇,竖提,撇,捺
补	点,横撇|横钩,竖,撇,点,竖,点
表	横,横,竖,横,撇,竖提,撇,捺
衩	点,横撇|横钩,竖,撇,点,横撇|横钩,捺,点
衫	点,横撇|横钩,竖,撇,点,撇,撇,撇
衬	点,横撇|横钩,竖,撇,点,横,竖钩,点
衮	点,横,撇,点,撇折,点,撇,竖提,撇,捺
衰	点,横,竖,横折,横,横,撇,竖提,撇,捺
衲	点,横撇|横钩,竖,撇,点,竖,横折钩,撇,点
衷	点,横,竖,横折,横,竖,撇,竖提,撇,捺
衽	点,横撇|横钩,竖,撇,点,撇,横,竖,横
衾	撇,捺,点,横撇|横钩,点,横,撇,竖提,撇,捺
衿	点,横撇|横钩,竖,撇,点,撇,捺,点,横撇|横钩
袁	横,竖,横,竖,横折,横,撇,竖提,撇,捺
袂	点,横撇|横钩,竖,撇,点,横折,横,撇,捺
袄	点,横撇|横钩,竖,撇,点,撇,横,撇,捺
袅	撇,横折钩,点,竖折折钩,点,横,撇,竖提,撇,捺
袆	
袈	横折钩,撇,竖,横折,横,点,横,撇,竖提,撇,捺
袋	撇,竖,横,斜钩|卧钩,点,点,横,撇,竖提,撇,捺
袍	点,横撇|横钩,竖,撇,点,撇,横折钩,横折,横,竖弯钩
袒	点,横撇|横钩,竖,撇,点,竖,横折,横,横,横
袖	点,横撇|横钩,竖,撇,点,竖,横折,横,竖,横
袗	
袜	点,横撇|横钩,竖,撇,点,横,横,竖,撇,捺
袢	点,横撇|横钩,竖,撇,点,点,撇,横,横,竖
袤	点,横,横撇|横钩,点,横撇|横钩,竖钩,撇,撇,竖提,撇,捺
袪	
被	点,横撇|横钩,竖,撇,点,横撇|横钩,撇,竖,横撇|横钩,捺
袭	横,撇,竖弯钩,撇,点,点,横,撇,竖提,撇,捺
袯	
袱	点,横撇|横钩,竖,撇,点,撇,竖,横,撇,捺,点
袷	点,横撇|横钩,竖,撇,点,撇,捺,横,竖,横折,横
袼	点,横撇|横钩,竖,撇,点,撇,横撇|横钩,捺,竖,横折,横
裁	横,竖,横,点,横,撇,竖提,撇,点,斜钩|卧钩,撇,点
裂	横,撇,横撇|横钩,点,竖,竖钩,点,横,撇,竖提,撇,捺
装	点,提,竖,横,竖,横,点,横,撇,竖提,撇,捺
裆	点,横撇|横钩,竖,撇,点,竖,点,撇,横折,横,横
裈	
裉	点,横撇|横钩,竖,撇,点,横折,横,横,竖提,撇,捺
裎	点,横撇|横钩,竖,撇,点,竖,横折,横,横,横,竖,横
裒	点,横,撇,竖,横,横折,横,横,撇,竖提,撇,捺
裔	点,横,撇,竖提,撇,捺,竖,横折钩,撇,点,竖,横折,横
裕	点,横撇|横钩,竖,撇,点,撇,点,撇,捺,竖,横折,横
裘	横,竖,点,提,撇,点,点,点,横,撇,竖提,撇,捺
裙	点,横撇|横钩,竖,撇,点,横折,横,横,撇,竖,横折,横
裛	
裟	点,点,提,竖,撇,点,撇,点,横,撇,竖提,撇,捺
裢	点,横撇|横钩,竖,撇,点,横,撇折,横,竖,点,横折折撇,捺
裣	点,横撇|横钩,竖,撇,点,撇,捺,横,点,点,撇,横
裤	点,横撇|横钩,竖,撇,点,点,横,撇,横,撇折,横,竖
裥	点,横撇|横钩,竖,撇,点,点,竖,横折钩,竖,横折,横,横
裨	点,横撇|横钩,竖,撇,点,撇,竖,横折,横,横,撇,横,竖
裰	点,横撇|横钩,竖,撇,点,横撇|横钩,点,横撇|横钩,点,横撇|横钩,点,横撇|横钩,捺
裱	点,横撇|横钩,竖,撇,点,横,横,竖,横,撇,竖提,撇,捺
裳	竖,点,撇,点2,横撇|横钩,竖,横折,横,点,横,撇,竖提,撇,捺
裴	竖,横,横,横,竖,横,横,横,点,横,撇,竖提,撇,捺
裸	点,横撇|横钩,竖,撇,点,竖,横折,横,横,横,竖,撇,捺
裹	点,横,竖,横折,横,横,横,竖,撇,点,撇,竖提,撇,捺
裼	点,横撇|横钩,竖,撇,点,竖,横折,横,横,撇,横折钩,撇,撇
裾	点,横撇|横钩,竖,撇,点,横折,横,撇,横,竖,竖,横折,横
褂	点,横撇|横钩,竖,撇,点,横,竖,横,横,竖,提,竖,点
褊	点,横撇|横钩,竖,撇,点,点,横折,横,撇,竖,横折钩,横,竖,竖
褐	点,横撇|横钩,竖,撇,点,竖,横折,横,横,撇,横折钩,撇,点,竖弯
褒	点,横,撇,竖,竖,横折,横,横,竖,撇,点,撇,竖提,撇,捺
褓	点,横撇|横钩,竖,撇,点,撇,竖,竖,横折,横,横,竖,撇,捺
褕	
褙	点,横撇|横钩,竖,撇,点,竖,横,提,撇,竖弯钩,竖,横折钩,横,横
褚	点,横撇|横钩,竖,撇,点,横,竖,横,撇,竖,横折,横,横
褛	点,横撇|横钩,竖,撇,点,点,撇,横,竖,撇,捺,撇点,撇,横
褟	
褡	点,横撇|横钩,竖,撇,点,横,竖,竖,撇,捺,横,竖,横折,横
褥	点,横撇|横钩,竖,撇,点,横,撇,横,横,竖提,撇,捺,横,竖钩,点
褪	点,横撇|横钩,竖,撇,点,横折,横,横,竖提,撇,点,点,横折折撇,捺
褫	点,横撇|横钩,竖,撇,点,撇,撇,竖,横,横撇|横钩,撇,横,竖弯钩,撇,横斜钩
褯	
褰	点,点2,横撇|横钩,横,横,竖,竖,横,撇,捺,点,横,撇,竖提,撇,捺
褴	点,横撇|横钩,竖,撇,点,竖,竖,撇,横,点,竖,横折,竖,竖,横
褶	点,横撇|横钩,竖,撇,点,横折,点,提,横折,点,提,撇,竖,横折,横,横
襁	点,横撇|横钩,竖,撇,点,横折,横,竖折折钩,竖,横折,横,竖,横折,横,竖,横,点
襄	点,横,竖,横折,横,竖,横折,横,横,横,竖,竖,横,撇,竖提,撇,捺
襕	
襚	
襜	
襞	横折,横,撇,竖,横折,横,点,横,点,撇,横,横,竖,点,横,撇,竖提,撇,捺
襟	点,横撇|横钩,竖,撇,点,横,竖,撇,点,横,竖,撇,捺,横,横,竖钩,撇,点
襦	点,横撇|横钩,竖,撇,点,横,点2,横撇|横钩,竖,点,点,点,点,横,撇,竖,横折钩,竖,竖
襫	
襻	点,横撇|横钩,竖,撇,点,横,竖,撇,点,撇,点,撇,点,横,竖,撇,点,横,撇,捺,撇,横,横,竖钩
西	横,竖,横折,撇,竖弯,横
要	横,竖,横折,竖,竖,横,撇点,撇,横
覃	横,竖,横折,竖,竖,横,竖,横折,横,横,横,竖
覆	横,竖,横折,竖,竖,横,撇,撇,竖,撇,横,竖,横折,横,横,撇,横撇|横钩,捺
见	竖,横折,撇,竖弯钩
观	横撇|横钩,点,竖,横折,撇,竖弯钩
觃	
规	横,横,撇,点,竖,横折,撇,竖弯钩
觅	撇,点,点,撇,竖,横折,撇,竖弯钩
视	点,横撇|横钩,竖,点,竖,横折,撇,竖弯钩
觇	竖,横,竖,横折,横,竖,横折,撇,竖弯钩
览	竖,竖,撇,横,点,竖,横折,撇,竖弯钩
觉	点,点,撇,点2,横撇|横钩,竖,横折,撇,竖弯钩
觊	竖,竖弯,竖,横折,横,竖提,竖,横折,撇,竖弯钩
觋	横,竖,撇,点,撇,点,提,竖,横折,撇,竖弯钩
觌	横,竖,横撇|横钩,点,点,横,撇,点,竖,横折,撇,竖弯钩
觎	撇,点,横,竖,横折钩,横,横,竖,竖钩,竖,横折,撇,竖弯钩
觏	横,横,竖,竖,横,竖,横折钩,竖,横,横,竖,横折,撇,竖弯钩
觐	横,竖,竖,横,竖,横折,横,横,横,竖,提,竖,横折,撇,竖弯钩
觑	竖,横,横撇|横钩,撇,横,竖弯钩,竖,竖,点,撇,提,竖,横折,撇,竖弯钩
角	撇,横撇|横钩,撇,横折钩,横,横,竖
觖	撇,横撇|横钩,撇,横折钩,横,横,竖,横折,横,撇,捺
觚	撇,横撇|横钩,撇,横折钩,横,横,竖,撇,撇,竖提,点,捺
觜	竖,横,竖,提,撇,竖弯钩,撇,横撇|横钩,撇,横折钩,横,横,竖
觞	撇,横撇|横钩,撇,横折钩,横,横,竖,撇,横,横折折折钩|横撇弯钩,撇,撇
觟	
解	撇,横撇|横钩,撇,横折钩,横,横,竖,横折钩,撇,撇,横,横,竖
觥	撇,横撇|横钩,撇,横折钩,横,横,竖,竖,点,撇,横,撇,竖弯钩
触	撇,横撇|横钩,撇,横折钩,横,横,竖,竖,横折,横,竖,横,点
觫	撇,横撇|横钩,撇,横折钩,横,横,竖,横,竖,横折,横,竖,撇,捺
觭	
觯	撇,横撇|横钩,撇,横折钩,横,横,竖,点,撇,竖,横折,横,横,横,竖
觱	
觳	横,竖,横,点2,横撇|横钩,横,撇,横撇|横钩,撇,横折钩,横,横,竖,撇,横折折|横折弯,横撇|横钩,捺
觿	
言	点,横,横,横,竖,横折,横
訄	
訇	撇,横折钩,点,横,横,横,竖,横折,横
訚	
訾	竖,横,竖,提,撇,竖弯钩,点,横,横,横,竖,横折,横
詈	竖,横折,竖,竖,横,点,横,横,横,竖,横折,横
詟	
詹	撇,横撇|横钩,横,撇,撇,点,点,横,横,横,竖,横折,横
誉	点,点,撇,横,撇,捺,点,横,横,横,竖,横折,横
誊	点,撇,横,横,撇,捺,点,横,横,横,竖,横折,横
誓	横,竖钩,提,撇,撇,横,竖,点,横,横,横,竖,横折,横
謇	点,点2,横撇|横钩,横,横,竖,竖,横,撇,捺,点,横,横,横,竖,横折,横
警	横,竖,竖,撇,横折钩,竖,横折,横,撇,横,撇,捺,点,横,横,横,竖,横折,横
譬	横折,横,撇,竖,横折,横,点,横,点,撇,横,横,竖,点,横,横,横,竖,横折,横
计	点,横折提,横,竖
订	点,横折提,横,竖钩
讣	点,横折提,竖,点
认	点,横折提,撇,捺
讥	点,横折提,撇,横斜钩
讦	点,横折提,横,横,竖
讧	点,横折提,横,竖,横
讨	点,横折提,横,竖钩,点
让	点,横折提,竖,横,横
讪	点,横折提,竖,竖弯,竖
讫	点,横折提,撇,横,横斜钩
训	点,横折提,撇,竖,竖
议	点,横折提,点,撇,捺
讯	点,横折提,横斜钩,横,竖
记	点,横折提,横折,横,竖弯钩
讱	
讲	点,横折提,横,横,撇,竖
讳	点,横折提,横,横,横折钩,竖
讴	点,横折提,横,撇,点,竖弯
讵	点,横折提,横,横折,横,竖弯
讶	点,横折提,横,撇折,竖钩,撇
讷	点,横折提,竖,横折钩,撇,点
许	点,横折提,撇,横,横,竖
讹	点,横折提,撇,竖,撇,竖弯钩
论	点,横折提,撇,捺,撇,竖弯钩
讻	
讼	点,横折提,撇,捺,撇折,点
讽	点,横折提,撇,横斜钩,撇,点
设	点,横折提,撇,横折折|横折弯,横撇|横钩,捺
访	点,横折提,点,横,横折钩,撇
诀	点,横折提,横折,横,撇,捺
证	点,横折提,横,竖,横,竖,横
诂	点,横折提,横,竖,竖,横折,横
诃	点,横折提,横,竖,横折,横,竖钩
评	点,横折提,横,点,撇,横,竖
诅	点,横折提,竖,横折,横,横,横
识	点,横折提,竖,横折,横,撇,点
诇	
诈	点,横折提,撇,横,竖,横,横
诉	点,横折提,撇,撇,横,竖,点
诊	点,横折提,撇,捺,撇,撇,撇
诋	点,横折提,撇,竖提,横,斜钩|卧钩,点
诌	点,横折提,撇,横撇|横钩,横折,横,横
词	点,横折提,横折钩,横,竖,横折,横
诎	点,横折提,竖弯,竖,竖,竖弯,竖
诏	点,横折提,横折钩,撇,竖,横折,横
诐	
译	点,横折提,横撇|横钩,捺,横,横,竖
诒	点,横折提,撇折,点,竖,横折,横
诓	点,横折提,横,横,横,竖,横,竖弯
诔	点,横折提,横,横,横,竖,撇,捺
试	点,横折提,横,横,竖,提,斜钩|卧钩,点
诖	点,横折提,横,竖,横,横,竖,横
诗	点,横折提,横,竖,横,横,竖钩,点
诘	点,横折提,横,竖,横,竖,横折,横
诙	点,横折提,横,撇,点2,撇,撇,捺
诚	点,横折提,横,撇,横折钩,斜钩|卧钩,撇,点
诛	点,横折提,撇,横,横,竖,撇,捺
诜	点,横折提,撇,横,竖,横,撇,竖弯钩
话	点,横折提,撇,横,竖,竖,横折,横
诞	点,横折提,撇,竖,横,竖弯,横折折撇,捺
诟	点,横折提,撇,撇,横,竖,横折,横
诠	点,横折提,撇,捺,横,横,竖,横
诡	点,横折提,撇,横撇|横钩,横,撇,横折钩,竖弯钩
询	点,横折提,撇,横折钩,竖,横折,横,横
诣	点,横折提,撇,竖弯钩,竖,横折,横,横
诤	点,横折提,撇,横撇|横钩,横折,横,横,竖钩
该	点,横折提,点,横,撇折,撇,撇,点
详	点,横折提,点,撇,横,横,横,竖
诧	点,横折提,点,点2,横撇|横钩,撇,横,竖弯钩
诨	点,横折提,点2,横撇|横钩,横,撇折,横,竖
诩	点,横折提,横折钩,点,提,横折钩,点,提
诫	点,横折提,横,横,撇,竖,斜钩|卧钩,撇,点
诬	点,横折提,横,竖,撇,点,撇,点,横
语	点,横折提,横,竖,横折,横,竖,横折,横
诮	点,横折提,竖,点,撇,竖,横折钩,横,横
误	点,横折提,竖,横折,横,横,横,撇,捺
诰	点,横折提,撇,横,竖,横,竖,横折,横
诱	点,横折提,撇,横,竖,撇,捺,横折折折钩|横撇弯钩,撇
诲	点,横折提,撇,横,竖弯,横折钩,点,横,点
诳	点,横折提,撇,弯钩,撇,横,横,竖,横
说	点,横折提,点,撇,竖,横折,横,撇,竖弯钩
诵	点,横折提,横撇|横钩,点,竖,横折钩,横,横,竖
请	点,横折提,横,横,竖,横,竖,横折钩,横,横
诸	点,横折提,横,竖,横,撇,竖,横折,横,横
诹	点,横折提,横,竖,竖,横,横,提,横撇|横钩,捺
诺	点,横折提,横,竖,竖,横,撇,竖,横折,横
读	点,横折提,横,竖,横撇|横钩,点,点,横,撇,点
诼	点,横折提,横,撇,弯钩,撇,撇,点,撇,捺
诽	点,横折提,竖,横,横,横,竖,横,横,横
课	点,横折提,竖,横折,横,横,横,竖,撇,捺
诿	点,横折提,撇,横,竖,撇,捺,撇点,撇,横
谀	点,横折提,撇,竖,横,横折,横,横,撇,捺
谁	点,横折提,撇,竖,点,横,横,横,竖,横
谂	点,横折提,撇,捺,点,横撇|横钩,点2,斜钩|卧钩,点,点
调	点,横折提,撇,横折钩,横,竖,横,竖,横折,横
谄	点,横折提,撇,横撇|横钩,撇,竖,横,横折,横,横
谅	点,横折提,点,横,竖,横折,横,竖钩,撇,点
谆	点,横折提,点,横,竖,横折,横,横撇|横钩,竖钩,横
谇	点,横折提,点,横,撇,点,撇,点,横,竖
谈	点,横折提,点2,撇,撇,点,点2,撇,撇,捺
谊	点,横折提,点,点2,横撇|横钩,竖,横折,横,横,横
谋	点,横折提,横,竖,竖,横,横,横,竖,撇,捺
谌	点,横折提,横,竖,竖,横,横,横,撇,点,竖弯
谍	点,横折提,横,竖,竖,横,竖弯,横,竖,撇,捺
谎	点,横折提,横,竖,竖,点,横,竖弯,撇,竖,竖弯钩
谏	点,横折提,横,竖,横折,点,撇,横,竖,撇,捺
谐	点,横折提,横,竖提,撇,竖弯钩,撇,竖,横折,横,横
谑	点,横折提,竖,横,横撇|横钩,撇,横,竖弯钩,横,竖弯,横
谒	点,横折提,竖,横折,横,横,撇,横折钩,撇,点,竖弯
谓	点,横折提,竖,横折,横,竖,横,竖,横折钩,横,横
谔	点,横折提,竖,横折,横,竖,横折,横,横,横,竖折折钩
谕	点,横折提,撇,捺,横,竖,横折钩,横,横,竖,竖钩
谖	点,横折提,撇,点,点,撇,横,横,撇,横撇|横钩,捺
谗	点,横折提,撇,横撇|横钩,竖,横折,横,撇,竖弯钩,点,点
谙	点,横折提,点,横,点,撇,横,竖,横折,横,横
谚	点,横折提,点,横,点,撇,横,撇,撇,撇,撇
谛	点,横折提,点,横,点,撇,点2,横撇|横钩,竖,横折钩,竖
谜	点,横折提,点,撇,横,竖,撇,点,点,横折折撇,捺
谝	点,横折提,点,横折,横,撇,竖,横折钩,横,竖,竖
谞	点,横折提,横撇|横钩,竖,横,撇,捺,竖,横折钩,横,横
谟	点,横折提,横,竖,竖,竖,横折,横,横,横,撇,捺
谠	点,横折提,竖,点,撇,点2,横撇|横钩,竖,横折,横,撇,竖弯钩
谡	点,横折提,竖,横折,横,竖,横,撇,点,撇,横撇|横钩,捺
谢	点,横折提,撇,竖,横折钩,横,横,横,撇,横,竖钩,点
谣	点,横折提,撇,点,点,撇,撇,横,横,竖,竖弯,竖
谤	点,横折提,点,横,点,撇,点2,横撇|横钩,点,横,横折钩,撇
谥	点,横折提,点,撇,横,撇,点,竖,横折,竖,竖,横
谦	点,横折提,点,撇,横,横折,横,横,竖,竖,撇,捺
谧	点,横折提,点2,斜钩|卧钩,点,撇,点,竖,横折,竖,竖,横
谨	点,横折提,横,竖,竖,横,竖,横折,横,横,横,竖,横
谩	点,横折提,竖,横折,横,横,竖,横折,竖,竖,横,横撇|横钩,捺
谪	点,横折提,点,横,点,撇,竖,横折钩,横,竖,竖,横折,横
谫	点,横折提,点,撇,横,竖,横折钩,横,横,竖,竖钩,横折钩,撇
谬	点,横折提,横折,点,提,横折,点,提,撇,捺,撇,撇,撇
谭	点,横折提,横,竖,横折,竖,竖,横,竖,横折,横,横,横,竖
谮	点,横折提,横,撇折,撇,竖提,横,撇折,撇,竖弯钩,竖,横折,横,横
谯	点,横折提,撇,竖,点,横,横,横,竖,横,点2,点,点,点
谰	点,横折提,点,竖,横折钩,横,竖,横折,点,撇,横,竖,撇,点
谱	点,横折提,点,撇,横,竖,竖,点,撇,横,竖,横折,横,横
谲	点,横折提,横撇|横钩,点,横撇|横钩,竖钩,撇,竖,横折钩,撇,点,竖,横折,横
谳	点,横折提,横,竖,竖,横折钩,点,撇,横,横,竖,横,撇,捺,点
谴	点,横折提,竖,横折,横,竖,横,竖,横折,横,横折,横,点,横折折撇,捺
谵	点,横折提,撇,横撇|横钩,横,撇,撇,点,点,横,横,横,竖,横折,横
谶	点,横折提,撇,点,撇,点,横,竖,横,横,横,竖,横,横,横,提,斜钩|卧钩,撇,点
谷	撇,点,撇,捺,竖,横折,横
谼	
谿	撇,点,点,撇,撇折,撇折,点,横,撇,点,撇,点,撇,捺,竖,横折,横
豁	点,点2,横撇|横钩,横,横,横,竖,竖,横折,横,撇,点,撇,捺,竖,横折,横
豆	横,竖,横折,横,点,撇,横
豇	横,竖,横折,横,点,撇,提,横,竖,横
豉	横,竖,横折,横,点,撇,提,横,竖,横撇|横钩,捺
豌	横,竖,横折,横,点,撇,提,点,点2,横撇|横钩,撇,横撇|横钩,点,横折钩,竖弯钩
豕	横,撇,弯钩,撇,撇,撇,捺
豚	撇,横折钩,横,横,横,撇,弯钩,撇,撇,撇,捺
象	撇,横撇|横钩,竖,横折,横,撇,弯钩,撇,撇,撇,捺
豢	点,撇,横,横,撇,捺,横,撇,弯钩,撇,撇,撇,点
豨	
豪	点,横,竖,横折,横,点2,横撇|横钩,横,撇,弯钩,撇,撇,撇,捺
豫	横撇|横钩,点,横撇|横钩,竖钩,撇,横撇|横钩,竖,横折,横,撇,弯钩,撇,撇,撇,捺
豮	
豳	竖,横,撇,弯钩,撇,撇,撇,点,横,撇,弯钩,撇,撇,撇,点,竖弯,竖
豸	撇,点,点,撇,弯钩,撇,撇
豹	撇,点,点,撇,弯钩,撇,撇,撇,横折钩,点
豺	撇,点,点,撇,弯钩,撇,撇,横,竖钩,撇
貂	撇,点,点,撇,弯钩,撇,撇,横折钩,撇,竖,横折,横
貅	撇,点,点,撇,弯钩,撇,撇,撇,竖,横,竖,撇,捺
貆	
貉	撇,点,点,撇,弯钩,撇,撇,撇,横撇|横钩,捺,竖,横折,横
貊	撇,点,点,撇,弯钩,撇,撇,横,撇,竖,横折,横,横
貌	撇,点,点,撇,弯钩,撇,撇,撇,竖,横折,横,横,撇,竖弯钩
貔	撇,点,点,撇,弯钩,撇,撇,撇,竖,横折,撇,点,横,横,竖提,撇,竖弯钩
貘	撇,点,点,撇,弯钩,撇,撇,横,竖,竖,竖,横折,横,横,横,撇,捺
贝	竖,横折,撇,点
贞	竖,横,竖,横折,撇,点
负	撇,横撇|横钩,竖,横折,撇,点
贡	横,竖,横,竖,横折,撇,点
财	竖,横折,撇,点,横,竖钩,撇
责	横,横,竖,横,竖,横折,撇,点
贤	竖,竖,横撇|横钩,捺,竖,横折,撇,点
败	竖,横折,撇,点,撇,横,撇,捺
账	竖,横折,撇,点,撇,横,竖提,捺
货	撇,竖,撇,竖弯钩,竖,横折,撇,点
质	撇,撇,横,竖,竖,横折,撇,点
贩	竖,横折,撇,点,撇,撇,横撇|横钩,捺
贪	撇,捺,点,横撇|横钩,竖,横折,撇,点
贫	撇,捺,横折钩,撇,竖,横折,撇,点
贬	竖,横折,撇,点,撇,点,横撇|横钩,捺
购	竖,横折,撇,点,撇,横折钩,撇折,点
贮	竖,横折,撇,点,点,点2,横撇|横钩,横
贯	竖弯,横折,竖,横,竖,横折,撇,点
贰	横,横,横,竖,横折,撇,点,斜钩|卧钩,点
贱	竖,横折,撇,点,横,横,斜钩|卧钩,撇,点
贲	横,竖,横,竖,竖,竖,横折,撇,点
贳	横,竖,竖,横,竖弯,竖,横折,撇,点
贴	竖,横折,撇,点,竖,横,竖,横折,横
贵	竖,横折,横,竖,横,竖,横折,撇,点
贶	竖,横折,撇,点,竖,横折,横,撇,竖弯钩
贷	撇,竖,横,斜钩|卧钩,点,竖,横折,撇,点
贸	撇,竖提,点,横折钩,撇,竖,横折,撇,点
费	横折,横,竖折折钩,撇,竖,竖,横折,撇,点
贺	横折钩,撇,竖,横折,横,竖,横折,撇,点
贻	竖,横折,撇,点,撇折,点,竖,横折,横
贼	竖,横折,撇,点,横,横,撇,斜钩|卧钩,撇,点
贽	横,竖钩,提,撇,横斜钩,点,竖,横折,撇,点
贾	横,竖,横折,竖,竖,横,竖,横折,撇,点
贿	竖,横折,撇,点,横,撇,竖,横折钩,横,横
赀	竖,横,竖,提,撇,竖弯钩,竖,横折,撇,点
赁	撇,竖,撇,横,竖,横,竖,横折,撇,点
赂	竖,横折,撇,点,撇,横撇|横钩,捺,竖,横折,横
赃	竖,横折,撇,点,点,横,撇,横,竖,横
资	点,提,撇,横撇|横钩,撇,捺,竖,横折,撇,点
赅	竖,横折,撇,点,点,横,撇折,撇,撇,点
赆	竖,横折,撇,点,横折,横,撇,捺,点,点
赇	竖,横折,撇,点,横,竖钩,点,提,撇,点,点
赈	竖,横折,撇,点,横,撇,横,横,竖提,撇,捺
赉	横,点,撇,横,竖,撇,捺,竖,横折,撇,点
赊	竖,横折,撇,点,撇,捺,横,横,竖钩,撇,点
赋	竖,横折,撇,点,横,横,竖,横,竖,提,斜钩|卧钩,点
赌	竖,横折,撇,点,横,竖,横,撇,竖,横折,横,横
赍	横,竖,撇,点,撇,点,点2,横撇|横钩,竖,横折,撇,点
赎	竖,横折,撇,点,横,竖,横撇|横钩,点,点,横,撇,点
赏	竖,点,撇,点2,横撇|横钩,竖,横折,横,竖,横折,撇,点
赐	竖,横折,撇,点,竖,横折,横,横,撇,横折钩,撇,撇
赑	
赒	
赓	点,横,撇,横折,横,横,撇,捺,竖,横折,撇,点
赔	竖,横折,撇,点,点,横,点,撇,横,竖,横折,横
赕	竖,横折,撇,点,点2,撇,撇,点,点2,撇,撇,捺
赖	横,竖,横折,横,竖,撇,点,撇,横撇|横钩,竖,横折,撇,点
赗	
赘	横,横,竖,横,横折钩,撇,撇,横,撇,捺,竖,横折,撇,点
赙	竖,横折,撇,点,横,竖,横折,横,横,竖,点,横,竖钩,点
赚	竖,横折,撇,点,点,撇,横,横折,横,横,竖,竖,撇,捺
赛	点,点2,横撇|横钩,横,横,竖,竖,横,撇,捺,竖,横折,撇,点
赜	横,竖,竖,横折,横,竖,竖弯,横,横,竖,横,竖,横折,撇,点
赝	横,撇,撇,竖,撇,竖,点,横,横,横,竖,横,竖,横折,撇,点
赞	撇,横,竖,横,撇,竖提,撇,横,竖,横,撇,竖弯钩,竖,横折,撇,点
赟	点,横,撇,点,横,横,竖,横,竖,提,斜钩|卧钩,点,竖,横折,撇,点
赠	竖,横折,撇,点,点,撇,竖,横折,竖,点,撇,横,竖,横折,横,横
赡	竖,横折,撇,点,撇,横撇|横钩,横,撇,撇,点,点,横,横,横,竖,横折,横
赢	点,横,竖弯,竖,横折,横,撇,横折钩,横,横,竖,横折,撇,点,撇,横斜钩,点
赣	点,横,点,撇,横,竖,横折,横,横,横,竖,撇,横撇|横钩,捺,横,竖,横,竖,横折,撇,点
赤	横,竖,横,撇,竖钩,撇,点
赦	横,竖,横,撇,竖钩,撇,点,撇,横,撇,捺
赧	横,竖,横,撇,竖钩,撇,点,横折钩,竖,横撇|横钩,捺
赪	
赫	横,竖,横,撇,竖钩,撇,点,横,竖,横,撇,竖钩,撇,点
赭	横,竖,横,撇,竖钩,撇,点,横,竖,横,撇,竖,横折,横,横
走	横,竖,横,竖,横,撇,捺
赳	横,竖,横,竖,横,撇,捺,竖提,竖
赴	横,竖,横,竖,横,撇,捺,竖,点
赵	横,竖,横,竖,横,撇,捺,撇,点
赶	横,竖,横,竖,横,撇,捺,横,横,竖
起	横,竖,横,竖,横,撇,捺,横折,横,竖弯钩
趁	横,竖,横,竖,横,撇,捺,撇,捺,撇,撇,撇
趄	横,竖,横,竖,横,撇,捺,竖,横折,横,横,横
超	横,竖,横,竖,横,撇,捺,横折钩,撇,竖,横折,横
越	横,竖,横,竖,横,撇,捺,横,竖提,斜钩|卧钩,撇,点
趋	横,竖,横,竖,横,撇,捺,撇,横撇|横钩,横折,横,横
趑	横,竖,横,竖,横,撇,捺,点,提,撇,横撇|横钩,撇,点
趔	横,竖,横,竖,横,撇,捺,横,撇,横撇|横钩,点,竖,竖钩
趟	横,竖,横,竖,横,撇,捺,竖,点,撇,竖,横折钩,竖,横折,横
趣	横,竖,横,竖,横,撇,捺,横,竖,竖,横,横,提,横撇|横钩,点
趯	
趱	横,竖,横,竖,横,撇,捺,撇,横,竖,横,撇,竖提,撇,横,竖,横,撇,竖弯钩,竖,横折,撇,点
足	竖,横折,横,竖,横,撇,捺
趴	竖,横折,横,竖,横,竖,提,撇,捺
趵	竖,横折,横,竖,横,竖,提,撇,横折钩,点
趸	横,横折钩,撇,竖,横折,横,竖,横,撇,捺
趺	竖,横折,横,竖,横,竖,提,横,横,撇,捺
趼	竖,横折,横,竖,横,竖,提,横,横,撇,竖
趾	竖,横折,横,竖,横,竖,提,竖,横,竖,横
趿	竖,横折,横,竖,横,竖,提,撇,横折折撇,捺
跂	
跃	竖,横折,横,竖,横,竖,提,撇,横,撇,捺
跄	竖,横折,横,竖,横,竖,提,撇,捺,横折钩,竖弯钩
跆	竖,横折,横,竖,横,竖,提,撇折,点,竖,横折,横
跋	竖,横折,横,竖,横,竖,提,横,撇,横撇|横钩,捺,点
跌	竖,横折,横,竖,横,竖,提,撇,横,横,撇,捺
跎	竖,横折,横,竖,横,竖,提,点,点2,横撇|横钩,撇,竖弯钩
跏	竖,横折,横,竖,横,竖,提,横折钩,撇,竖,横折,横
跐	
跑	竖,横折,横,竖,横,竖,提,撇,横折钩,横折,横,竖弯钩
跖	竖,横折,横,竖,横,竖,提,横,撇,竖,横折,横
跗	竖,横折,横,竖,横,竖,提,撇,竖,横,竖钩,点
跚	竖,横折,横,竖,横,竖,提,撇,横折钩,撇,横折钩,横
跛	竖,横折,横,竖,横,竖,提,横撇|横钩,撇,竖,横撇|横钩,捺
距	竖,横折,横,竖,横,竖,提,横,横折,横,竖弯
跞	竖,横折,横,竖,横,竖,提,撇,竖弯,竖钩,撇,点
跟	竖,横折,横,竖,横,竖,提,横折,横,横,竖提,撇,捺
跣	竖,横折,横,竖,横,竖,提,撇,横,竖,横,撇,竖弯钩
跤	竖,横折,横,竖,横,竖,提,点,横,撇,点,撇,捺
跨	竖,横折,横,竖,横,竖,提,横,撇,捺,横,横,竖折折钩
跪	竖,横折,横,竖,横,竖,提,撇,横撇|横钩,横,撇,横折钩,竖弯钩
跬	竖,横折,横,竖,横,竖,提,横,竖,横,横,竖,横
路	竖,横折,横,竖,横,竖,提,撇,横撇|横钩,捺,竖,横折,横
跱	
跳	竖,横折,横,竖,横,竖,提,撇,点,提,竖弯钩,撇,点
践	竖,横折,横,竖,横,竖,提,横,横,斜钩|卧钩,撇,点
跶	竖,横折,横,竖,横,竖,提,横,撇,点,点,横折折撇,捺
跷	竖,横折,横,竖,横,竖,提,横,斜钩|卧钩,撇,横,撇,竖弯钩
跸	竖,横折,横,竖,横,竖,提,横,竖提,撇,竖弯钩,横,竖
跹	竖,横折,横,竖,横,竖,提,撇,横,竖,点,横折折撇,捺
跺	竖,横折,横,竖,横,竖,提,撇,横折折|横折弯,横,竖,撇,捺
跻	竖,横折,横,竖,横,竖,提,点,横,撇,捺,撇,竖
跽	竖,横折,横,竖,横,竖,提,横折,横,竖弯钩,点2,斜钩|卧钩,点,点
踅	横,竖钩,提,撇,撇,横,竖,竖,横折,横,竖,横,撇,捺
踉	竖,横折,横,竖,横,竖,提,点,横折,横,横,竖提,撇,捺
踊	竖,横折,横,竖,横,竖,提,横撇|横钩,点,竖,横折钩,横,横,竖
踌	竖,横折,横,竖,横,竖,提,横,横,横,撇,横,竖钩,点
踏	竖,横折,横,竖,横,竖,提,竖钩,横撇|横钩,撇,捺,竖,横折,横,横
踒	
踔	竖,横折,横,竖,横,竖,提,竖,横,竖,横折,横,横,横,竖
踝	竖,横折,横,竖,横,竖,提,竖,横折,横,横,横,竖,撇,捺
踞	竖,横折,横,竖,横,竖,提,横折,横,撇,横,竖,竖,横折,横
踟	竖,横折,横,竖,横,竖,提,撇,横,横,撇,点,竖,横折,横
踢	竖,横折,横,竖,横,竖,提,竖,横折,横,横,撇,横折钩,撇,撇
踣	竖,横折,横,竖,横,竖,提,点,横,点,撇,横,竖,横折,横
踦	
踩	竖,横折,横,竖,横,竖,提,撇,点,点,撇,横,竖,撇,捺
踪	竖,横折,横,竖,横,竖,提,点,点2,横撇|横钩,横,横,竖钩,撇,点
踬	竖,横折,横,竖,横,竖,提,撇,撇,横,竖,竖,横折,撇,点
踮	竖,横折,横,竖,横,竖,提,点,横,撇,竖,横,竖,横折,横
踯	竖,横折,横,竖,横,竖,提,点,撇,横,横,撇,点,横折折折钩|横撇弯钩,竖
踱	竖,横折,横,竖,横,竖,提,点,横,撇,横,竖,竖,横,横撇|横钩,捺
踵	竖,横折,横,竖,横,竖,提,撇,横,竖,横折,横,横,竖,横,横
踶	
踹	竖,横折,横,竖,横,竖,提,竖,竖弯,竖,横,撇,竖,横折钩,竖,竖
踺	竖,横折,横,竖,横,竖,提,横折,横,横,横,横,竖,横折折撇,捺
踽	竖,横折,横,竖,横,竖,提,撇,竖,横折,横,竖,横折钩,竖,提,点
蹀	竖,横折,横,竖,横,竖,提,横,竖,竖,横,竖弯,横,竖,撇,捺
蹁	竖,横折,横,竖,横,竖,提,点,横折,横,撇,竖,横折钩,横,竖,竖
蹂	竖,横折,横,竖,横,竖,提,横撇|横钩,点,横撇|横钩,竖钩,撇,横,竖,撇,捺
蹄	竖,横折,横,竖,横,竖,提,点,横,点,撇,点2,横撇|横钩,竖,横折钩,竖
蹅	
蹇	点,点2,横撇|横钩,横,横,竖,竖,横,撇,捺,竖,横折,横,竖,横,撇,捺
蹈	竖,横折,横,竖,横,竖,提,撇,点,点,撇,撇,竖,横,横折,横,横
蹉	竖,横折,横,竖,横,竖,提,点,撇,横,横,横,撇,横,竖,横
蹊	竖,横折,横,竖,横,竖,提,撇,点,点,撇,撇折,撇折,点,横,撇,捺
蹋	竖,横折,横,竖,横,竖,提,竖,横折,横,横,横折钩,点,提,横折钩,点,提
蹐	
蹑	竖,横折,横,竖,横,竖,提,横,竖,竖,横,横,横,横撇|横钩,点,横撇|横钩,捺
蹒	竖,横折,横,竖,横,竖,提,横,竖,竖,横,竖,横折钩,撇,点,撇,点
蹙	横,撇,竖,横,横,竖钩,撇,点,斜钩|卧钩,撇,点,竖,横折,横,竖,横,撇,捺
蹚	竖,横折,横,竖,横,竖,提,竖,点,撇,点2,横撇|横钩,竖,横折,横,横,竖,横
蹜	
蹢	
蹦	竖,横折,横,竖,横,竖,提,竖,竖弯,竖,撇,横折钩,横,横,撇,横折钩,横,横
蹩	点,撇,竖,横折钩,竖,撇,点,撇,横,撇,捺,竖,横折,横,竖,横,撇,捺
蹬	竖,横折,横,竖,横,竖,提,横撇|横钩,点,撇,撇,捺,横,竖,横折,横,点,撇,横
蹭	竖,横折,横,竖,横,竖,提,点,撇,竖,横折,竖,点,撇,横,竖,横折,横,横
蹯	竖,横折,横,竖,横,竖,提,撇,点,撇,横,竖,撇,捺,竖,横折,横,竖,横
蹰	竖,横折,横,竖,横,竖,提,横,撇,横,竖,横折,横,点,撇,提,横,竖钩,点
蹲	竖,横折,横,竖,横,竖,提,点,撇,横,竖,横折,撇,竖弯,横,横,横,竖钩,点
蹴	竖,横折,横,竖,横,竖,提,点,横,竖,横折,横,竖钩,撇,点,横,撇,竖弯钩,点
蹶	竖,横折,横,竖,横,竖,提,横,撇,点,撇,横,竖弯,竖,撇,撇,横撇|横钩,撇,捺
蹼	竖,横折,横,竖,横,竖,提,竖,竖,点,撇,横,点,撇,横,横,横,撇,捺
蹽	
蹾	
蹿	竖,横折,横,竖,横,竖,提,点,点2,横撇|横钩,撇,点,竖,横折,横,竖,横折,横,竖
躁	竖,横折,横,竖,横,竖,提,竖,横折,横,竖,横折,横,竖,横折,横,横,竖,撇,捺
躅	竖,横折,横,竖,横,竖,提,竖,横折,竖,竖,横,撇,横折钩,竖,横折,横,竖,横,点
躇	竖,横折,横,竖,横,竖,提,横,竖,竖,横,竖,横,撇,竖,横折,横,横
躏	竖,横折,横,竖,横,竖,提,横,竖,竖,点,竖,横折钩,撇,竖,点,横,横,横,竖,横
躐	竖,横折,横,竖,横,竖,提,撇点,撇点,撇点,竖,横折,撇,点,横,竖提,点,点,竖提,点,点,斜钩|卧钩
躔	竖,横折,横,竖,横,竖,提,点,横,撇,竖,横折,横,横,竖,横,横,撇,点,横,竖,横
躜	竖,横折,横,竖,横,竖,提,撇,横,竖,横,撇,竖提,撇,横,竖,横,撇,竖弯钩,竖,横折,撇,点
躞	竖,横折,横,竖,横,竖,提,点,横,横,横,竖,横折,横,点2,撇,撇,点,点2,撇,撇,点,横撇|横钩,捺
身	撇,竖,横折钩,横,横,横,撇
躬	撇,竖,横折钩,横,横,横,撇,横折,横,竖折折钩
躯	撇,竖,横折钩,横,横,横,撇,横,撇,点,竖弯
躲	撇,竖,横折钩,横,横,横,撇,撇,横折折|横折弯,横,竖,撇,捺
躺	撇,竖,横折钩,横,横,横,撇,竖,点,撇,竖,横折钩,竖,横折,横
车	横,撇折,横,竖
轧	横,撇折,竖,提,竖弯钩
轨	横,撇折,竖,提,撇,横斜钩
轩	横,撇折,竖,提,横,横,竖
轪	
轫	横,撇折,竖,提,横折钩,撇,点2
转	横,撇折,竖,提,横,横,竖折撇|竖折折,点
轭	横,撇折,竖,提,横,撇,横折钩,竖弯钩
轮	横,撇折,竖,提,撇,捺,撇,竖弯钩
软	横,撇折,竖,提,撇,横撇|横钩,撇,捺
轰	横,撇折,横,竖,横撇|横钩,点,横撇|横钩,捺
轱	横,撇折,竖,提,横,竖,竖,横折,横
轲	横,撇折,竖,提,横,竖,横折,横,竖钩
轳	横,撇折,竖,提,竖,横,横折,横,撇
轴	横,撇折,竖,提,竖,横折,横,竖,横
轵	横,撇折,竖,提,竖,横折,横,撇,点
轶	横,撇折,竖,提,撇,横,横,撇,捺
轷	横,撇折,竖,提,撇,点,撇,横,竖钩
轸	横,撇折,竖,提,撇,捺,撇,撇,撇
轹	横,撇折,竖,提,撇,竖弯,竖钩,撇,点
轺	横,撇折,竖,提,横折钩,撇,竖,横折,横
轻	横,撇折,竖,提,横撇|横钩,点,横,竖,横
轼	横,撇折,竖,提,横,横,竖,提,斜钩|卧钩,点
载	横,竖,横,横,撇折,竖,提,斜钩|卧钩,撇,点
轾	横,撇折,竖,提,横,撇折,点,横,竖,横
轿	横,撇折,竖,提,撇,横,撇,捺,撇,竖
辀	
辁	横,撇折,竖,提,撇,捺,横,横,竖,横
辂	横,撇折,竖,提,撇,横撇|横钩,捺,竖,横折,横
较	横,撇折,竖,提,点,横,撇,点,撇,捺
辄	横,撇折,竖,提,横,竖,竖,横,横,提,竖弯钩
辅	横,撇折,竖,提,横,竖,横折钩,横,横,竖,点
辆	横,撇折,竖,提,横,竖,横折钩,撇,点,撇,点
辇	横,横,撇,点,横,横,撇,捺,横,撇折,横,竖
辈	竖,横,横,横,竖,横,横,横,横,撇折,横,竖
辉	竖,点,撇,横,撇,竖提,点2,横撇|横钩,横,撇折,横,竖
辊	横,撇折,竖,提,竖,横折,横,横,横,竖提,撇,竖弯钩
辋	横,撇折,竖,提,竖,横折钩,点,撇,横,点,横,竖弯
辌	
辍	横,撇折,竖,提,横撇|横钩,点,横撇|横钩,点,横撇|横钩,点,横撇|横钩,捺
辎	横,撇折,竖,提,撇点,撇点,撇点,竖,横折,横,竖,横
辏	横,撇折,竖,提,横,横,横,撇,捺,横,横,撇,点
辐	横,撇折,竖,提,横,竖,横折,横,竖,横折,横,竖,横
辑	横,撇折,竖,提,竖,横折,横,横,竖,竖,横,横,横
辒	
输	横,撇折,竖,提,撇,捺,横,竖,横折钩,横,横,竖,竖钩
辔	撇折,撇折,提,横,撇折,横,竖,撇折,撇折,提,竖,横折,横
辕	横,撇折,竖,提,横,竖,横,竖,横折,横,撇,竖提,撇,捺
辖	横,撇折,竖,提,点,点2,横撇|横钩,横,横,横,竖,竖,横折,横
辗	横,撇折,竖,提,横折,横,撇,横,竖,竖,横,竖提,撇,捺
辘	横,撇折,竖,提,点,横,撇,横折,竖,竖,横,横,竖提,撇,竖弯钩
辙	横,撇折,竖,提,点,横,撇折,点,竖,横折钩,横,横,撇,横,撇,捺
辚	横,撇折,竖,提,点,撇,横,竖,撇,捺,撇,横撇|横钩,点,横,撇折,竖
辛	点,横,点,撇,横,横,竖
辜	横,竖,竖,横折,横,点,横,点,撇,横,横,竖
辞	撇,横,竖,竖,横折,横,点,横,点,撇,横,横,竖
辟	横折,横,撇,竖,横折,横,点,横,点,撇,横,横,竖
辣	点,横,点,撇,横,横,撇,横,竖,横折,横,竖,撇,捺
辨	点,横,点,撇,横,横,撇,点2,撇,点,横,点,撇,横,横,竖
辩	点,横,点,撇,横,横,撇,点,横折提,点,横,点,撇,横,横,竖
辫	点,横,点,撇,横,横,撇,撇折,撇折,提,点,横,点,撇,横,横,竖
辰	横,撇,横,横,竖提,撇,捺
辱	横,撇,横,横,竖提,撇,捺,横,竖钩,点
边	横折钩,撇,点,横折折撇,捺
辽	横撇|横钩,竖钩,点,横折折撇,捺
达	横,撇,点,点,横折折撇,捺
辿	
迁	撇,横,竖,点,横折折撇,捺
迂	横,横,竖钩,点,横折折撇,捺
迄	撇,横,横斜钩,点,横折折撇,捺
迅	横斜钩,横,竖,点,横折折撇,捺
过	横,竖钩,点,点,横折折撇,捺
迈	横,横折钩,撇,点,横折折撇,捺
迎	撇,竖提,横折钩,竖,点,横折折撇,捺
运	横,横,撇折,点,点,横折折撇,捺
近	撇,撇,横,竖,点,横折折撇,捺
迓	横,撇折,竖钩,撇,点,横折折撇,捺
返	撇,撇,横撇|横钩,点,点,横折折撇,捺
迕	撇,横,横,竖,点,横折折撇,捺
还	横,撇,竖,点,点,横折折撇,捺
这	点,横,撇,点,点,横折折撇,捺
进	横,横,撇,竖,点,横折折撇,捺
远	横,横,撇,竖弯钩,点,横折折撇,捺
违	横,横,横折钩,竖,点,横折折撇,捺
连	横,撇折,横,竖,点,横折折撇,捺
迟	横折,横,撇,点,点,横折折撇,捺
迢	横折钩,撇,竖,横折,横,点,横折折撇,捺
迤	撇,横,横折钩,竖,竖弯钩,点,横折折撇,捺
迥	竖,横折钩,竖,横折,横,点,横折折撇,捺
迦	横折钩,撇,竖,横折,横,点,横折折撇,捺
迨	撇折,点,竖,横折,横,点,横折折撇,捺
迩	撇,横撇|横钩,竖钩,撇,点,点,横折折撇,捺
迪	竖,横折,横,竖,横,点,横折折撇,捺
迫	撇,竖,横折,横,横,点,横折折撇,捺
迭	撇,横,横,撇,点,点,横折折撇,捺
迮	撇,横,竖,横,横,点,横折折撇,捺
述	横,竖,撇,点,点,点,横折折撇,捺
迳	横撇|横钩,点,横,竖,横,点,横折折撇,捺
迷	点,撇,横,竖,撇,点,点,横折折撇,捺
迸	点,撇,横,横,撇,竖,点,横折折撇,捺
迹	点,横,撇,竖钩,撇,点,点,横折折撇,捺
迺	
追	撇,竖,横折,横,横折,横,点,横折折撇,捺
退	横折,横,横,竖提,撇,点,点,横折折撇,捺
送	点,撇,横,横,撇,点,点,横折折撇,捺
适	撇,横,竖,竖,横折,横,点,横折折撇,捺
逃	撇,点,提,竖弯钩,撇,点,点,横折折撇,捺
逄	撇,横撇|横钩,捺,横,撇折,竖,点,横折折撇,捺
逅	撇,撇,横,竖,横折,横,点,横折折撇,捺
逆	点,撇,横,竖弯,竖,撇,点,横折折撇,捺
选	撇,横,竖,横,撇,竖弯钩,点,横折折撇,捺
逊	横撇|横钩,竖钩,提,竖钩,撇,点,点,横折折撇,捺
逋	横,竖,横折钩,横,横,竖,点,点,横折折撇,捺
逍	竖,点,撇,竖,横折钩,横,横,点,横折折撇,捺
透	撇,横,竖,撇,捺,横折折折钩|横撇弯钩,撇,点,横折折撇,捺
逐	横,撇,弯钩,撇,撇,撇,点,点,横折折撇,捺
逑	横,竖钩,点,提,撇,点,点,点,横折折撇,捺
递	点,撇,横折,横,竖折折钩,竖,撇,点,横折折撇,捺
途	撇,捺,横,横,竖钩,撇,点,点,横折折撇,捺
逖	撇,弯钩,撇,点2,撇,撇,点,点,横折折撇,捺
逗	横,竖,横折,横,点,撇,横,点,横折折撇,捺
通	横撇|横钩,点,竖,横折钩,横,横,竖,点,横折折撇,捺
逛	撇,弯钩,撇,横,横,竖,横,点,横折折撇,捺
逝	横,竖钩,提,撇,撇,横,竖,点,横折折撇,捺
逞	竖,横折,横,横,横,竖,横,点,横折折撇,捺
速	横,竖,横折,横,竖,撇,点,点,横折折撇,捺
造	撇,横,竖,横,竖,横折,横,点,横折折撇,捺
逡	撇折,点,撇,点,撇,横撇|横钩,点,点,横折折撇,捺
逢	撇,横撇|横钩,捺,横,横,横,竖,点,横折折撇,捺
逦	横,竖,横折钩,点,竖,横折钩,点,点,横折折撇,捺
逭	点,点2,横撇|横钩,竖,横折,横,横折,横,点,横折折撇,捺
逮	横折,横,横,竖钩,点,提,撇,点,点,横折折撇,捺
逯	横折,横,横,竖钩,点,提,撇,点,点,横折折撇,捺
逴	
逵	横,竖,横,撇,点,横,竖,横,点,横折折撇,捺
逶	撇,横,竖,撇,点,撇点,撇,横,点,横折折撇,捺
逸	撇,横撇|横钩,竖,横折,横,撇,竖弯钩,点,点,横折折撇,捺
逻	竖,横折,竖,竖,横,撇,横撇|横钩,点,点,横折折撇,捺
逼	横,竖,横折,横,竖,横折,横,竖,横,点,横折折撇,捺
逾	撇,捺,横,竖,横折钩,横,横,竖,竖钩,点,横折折撇,捺
遁	撇,撇,横,竖,竖,横折,横,横,横,点,横折折撇,捺
遂	点,撇,横,撇,弯钩,撇,撇,撇,点,点,横折折撇,捺
遄	竖,竖弯,竖,横,撇,竖,横折钩,竖,竖,点,横折折撇,捺
遆	
遇	竖,横折,横,横,竖,横折钩,竖,提,点,点,横折折撇,捺
遍	点,横折,横,撇,竖,横折钩,横,竖,竖,点,横折折撇,捺
遏	竖,横折,横,横,撇,横折钩,撇,点,竖弯,点,横折折撇,捺
遐	横折,横,竖,横,横,横折,横,横撇|横钩,点,点,横折折撇,捺
遑	撇,竖,横折,横,横,横,横,竖,横,点,横折折撇,捺
遒	点,撇,横,竖,横折,撇,竖弯,横,横,点,横折折撇,捺
道	点,撇,横,撇,竖,横折,横,横,横,点,横折折撇,捺
遗	竖,横折,横,竖,横,竖,横折,撇,点,点,横折折撇,捺
遘	横,横,竖,竖,横,竖,横折钩,竖,横,横,点,横折折撇,捺
遛	撇,竖提,点,横折钩,撇,竖,横折,横,竖,横,点,横折折撇,捺
遢	竖,横折,横,横,横折钩,点,提,横折钩,点,提,点,横折折撇,捺
遣	竖,横折,横,竖,横,竖,横折,横,横折,横,点,横折折撇,捺
遥	撇,点,点,撇,撇,横,横,竖,竖弯,竖,点,横折折撇,捺
遨	横,横,竖,横,横折钩,撇,撇,横,撇,点,点,横折折撇,捺
遭	横,竖,横折,横,竖,竖,横,竖,横折,横,横,点,横折折撇,捺
遮	点,横,撇,横,竖,竖,横,点2,点,点,点,点,横折折撇,捺
遴	点,撇,横,竖,撇,点,撇,横撇|横钩,点,横,撇折,竖,点,横折折撇,捺
遵	点,撇,横,竖,横折,撇,竖弯,横,横,横,竖钩,点,点,横折折撇,捺
遹	
遽	竖,横,横撇|横钩,撇,横,竖弯钩,横,撇,弯钩,撇,撇,撇,点,点,横折折撇,捺
避	横折,横,撇,竖,横折,横,点,横,点,撇,横,横,竖,点,横折折撇,捺
邀	撇,竖,横折,横,横,点,横,横折钩,撇,撇,横,撇,点,点,横折折撇,捺
邂	撇,横撇|横钩,撇,横折钩,横,横,竖,横折钩,撇,撇,横,横,竖,点,横折折撇,捺
邃	点,点2,横撇|横钩,撇,点,点,撇,横,撇,弯钩,撇,撇,撇,点,点,横折折撇,捺
邈	撇,点,点,撇,弯钩,撇,撇,撇,竖,横折,横,横,撇,竖弯钩,点,横折折撇,捺
邋	撇点,撇点,撇点,竖,横折,撇,点,横,竖提,点,点,竖提,点,点,斜钩|卧钩,点,横折折撇,捺
邑	竖,横折,横,横折,竖,横,竖弯钩
邓	横撇|横钩,点,横折折折钩|横撇弯钩,竖
邕	撇点,撇点,撇点,竖,横折,横,横折,竖,横,竖弯钩
邗	横,横,竖,横折折折钩|横撇弯钩,竖
邘	
邙	点,横,竖弯,横折折折钩|横撇弯钩,竖
邛	横,竖,提,横折折折钩|横撇弯钩,竖
邝	点,横,撇,横折折折钩|横撇弯钩,竖
邠	
邡	点,横,横折钩,撇,横折折折钩|横撇弯钩,竖
邢	横,横,撇,竖,横折折折钩|横撇弯钩,竖
那	横折钩,横,横,撇,横折折折钩|横撇弯钩,竖
邦	横,横,横,撇,横折折折钩|横撇弯钩,竖
邨	横,竖弯,竖,竖提,横折折折钩|横撇弯钩,竖
邪	横,撇折,竖钩,撇,横折折折钩|横撇弯钩,竖
邬	撇,横折钩,竖折折钩,提,横折折折钩|横撇弯钩,竖
邮	竖,横折,横,竖,横,横折折折钩|横撇弯钩,竖
邯	横,竖,竖,横,横,横折折折钩|横撇弯钩,竖
邰	撇折,点,竖,横折,横,横折折折钩|横撇弯钩,竖
邱	撇,竖,横,竖,提,横折折折钩|横撇弯钩,竖
邲	
邳	横,撇,竖,点,提,横折折折钩|横撇弯钩,竖
邴	横,竖,横折钩,撇,点,横折折折钩|横撇弯钩,竖
邵	横折钩,撇,竖,横折,横,横折折折钩|横撇弯钩,竖
邶	竖,横,提,横,竖提,横折折折钩|横撇弯钩,竖
邸	撇,竖提,横,斜钩|卧钩,点,横折折折钩|横撇弯钩,竖
邹	撇,横撇|横钩,横折,横,横,横折折折钩|横撇弯钩,竖
邺	竖,竖,点,撇,提,横折折折钩|横撇弯钩,竖
邻	撇,点,点,横撇|横钩,点,横折折折钩|横撇弯钩,竖
邽	
邾	撇,横,横,竖,撇,点,横折折折钩|横撇弯钩,竖
邿	
郁	横,撇,竖,横折钩,横,横,横折折折钩|横撇弯钩,竖
郃	撇,点,横,竖,横折,横,横折折折钩|横撇弯钩,竖
郄	撇,点,横,撇,撇折,点,横折折折钩|横撇弯钩,竖
郅	横,撇折,点,横,竖,提,横折折折钩|横撇弯钩,竖
郇	撇,横折钩,竖,横折,横,横,横折折折钩|横撇弯钩,竖
郈	
郊	点,横,撇,点,撇,点,横折折折钩|横撇弯钩,竖
郎	点,横折,横,横,竖提,点,横折折折钩|横撇弯钩,竖
郏	横,点,撇,横,撇,点,横折折折钩|横撇弯钩,竖
郐	撇,点,横,横,撇折,点,横折折折钩|横撇弯钩,竖
郑	点,撇,横,横,撇,点,横折折折钩|横撇弯钩,竖
郓	点2,横撇|横钩,横,撇折,竖,提,横折折折钩|横撇弯钩,竖
郗	撇,点,横,撇,竖,横折钩,竖,横折折折钩|横撇弯钩,竖
郚	
郛	撇,点,点,撇,横撇|横钩,竖钩,提,横折折折钩|横撇弯钩,竖
郜	撇,横,竖,横,竖,横折,横,横折折折钩|横撇弯钩,竖
郝	横,竖,横,撇,竖钩,撇,点,横折折折钩|横撇弯钩,竖
郡	横折,横,横,撇,竖,横折,横,横折折折钩|横撇弯钩,竖
郢	竖,横折,横,横,横,竖,提,横折折折钩|横撇弯钩,竖
郤	撇,点,撇,点,竖,横折,横,横折折折钩|横撇弯钩,竖
郦	横,竖,横折钩,点,竖,横折钩,点,横折折折钩|横撇弯钩,竖
郧	竖,横折,横,竖,横折,撇,点,横折折折钩|横撇弯钩,竖
部	点,横,点,撇,横,竖,横折,横,横折折折钩|横撇弯钩,竖
郪	
郫	撇,竖,横折,横,横,撇,横,竖,横折折折钩|横撇弯钩,竖
郭	点,横,竖,横折,横,横撇|横钩,竖钩,提,横折折折钩|横撇弯钩,竖
郯	点2,撇,撇,点,点2,撇,撇,点,横折折折钩|横撇弯钩,竖
郴	横,竖,撇,点,横,竖,撇,点,横折折折钩|横撇弯钩,竖
郸	点,撇,竖,横折,横,横,横,竖,横折折折钩|横撇弯钩,竖
都	横,竖,横,撇,竖,横折,横,横,横折折折钩|横撇弯钩,竖
郾	横,竖,横折,横,横,撇点,撇,横,竖弯,横折折折钩|横撇弯钩,竖
郿	
鄀	
鄂	竖,横折,横,竖,横折,横,横,横,竖折折钩,横折折折钩|横撇弯钩,竖
鄃	
鄄	横,竖,横折,竖,竖,横,横,竖,提,横折折折钩|横撇弯钩,竖
鄅	
鄌	
鄑	
鄗	
鄘	点,横,撇,横折,横,横,竖,横折钩,横,横,竖,横折折折钩|横撇弯钩,竖
鄙	竖,横折,横,横,竖,竖,横折,竖,横折,横,横,横折折折钩|横撇弯钩,竖
鄚	
鄜	
鄞	横,竖,竖,横,竖,横折,横,横,横,竖,提,横折折折钩|横撇弯钩,竖
鄠	横,点2,横撇|横钩,竖,点,点,点,点,横,横,竖折折钩,横折折折钩|横撇弯钩,竖
鄢	横,竖,横,竖,横,横,竖折折钩,点2,点,点,点,横折折折钩|横撇弯钩,竖
鄣	点,横,点,撇,横,竖,横折,横,横,横,竖,横折折折钩|横撇弯钩,竖
鄫	
鄯	点,撇,横,横,横,竖,点,撇,横,竖,横折,横,横折折折钩|横撇弯钩,竖
鄱	撇,点,撇,横,竖,撇,点,竖,横折,横,竖,横,横折折折钩|横撇弯钩,竖
鄹	横,竖,竖,横,横,提,横撇|横钩,点,撇,竖,撇,撇,撇,点,横折折折钩|横撇弯钩,竖
酂	
酃	横,点2,横撇|横钩,竖,点,点,点,点,竖,横折,横,竖,横折,横,竖,横折,横,横折折折钩|横撇弯钩,竖
酅	
酆	竖,横,横,横,竖,横,横,横,竖,竖弯,竖,横,竖,横折,横,点,撇,提,横折折折钩|横撇弯钩,竖
酉	横,竖,横折,撇,竖弯,横,横
酊	横,竖,横折,撇,竖弯,横,横,横,竖钩
酋	点,撇,横,竖,横折,撇,竖弯,横,横
酌	横,竖,横折,撇,竖弯,横,横,撇,横折钩,点
配	横,竖,横折,撇,竖弯,横,横,横折,横,竖弯钩
酎	横,竖,横折,撇,竖弯,横,横,横,竖钩,点
酏	横,竖,横折,撇,竖弯,横,横,横折钩,竖,竖弯钩
酐	横,竖,横折,撇,竖弯,横,横,横,横,竖
酒	点,点,提,横,竖,横折,撇,竖弯,横,横
酗	横,竖,横折,撇,竖弯,横,横,撇,点,竖弯,竖
酚	横,竖,横折,撇,竖弯,横,横,撇,捺,横折钩,撇
酝	横,竖,横折,撇,竖弯,横,横,横,横,撇折,点
酞	横,竖,横折,撇,竖弯,横,横,横,撇,捺,点
酡	横,竖,横折,撇,竖弯,横,横,点,点2,横撇|横钩,撇,竖弯钩
酢	横,竖,横折,撇,竖弯,横,横,撇,横,竖,横,横
酣	横,竖,横折,撇,竖弯,横,横,横,竖,竖,横,横
酤	横,竖,横折,撇,竖弯,横,横,横,竖,竖,横折,横
酥	横,竖,横折,撇,竖弯,横,横,撇,横,竖,撇,捺
酦	
酩	横,竖,横折,撇,竖弯,横,横,撇,横撇|横钩,点,竖,横折,横
酪	横,竖,横折,撇,竖弯,横,横,撇,横撇|横钩,捺,竖,横折,横
酬	横,竖,横折,撇,竖弯,横,横,点2,撇,点,竖,点,竖
酮	横,竖,横折,撇,竖弯,横,横,竖,横折钩,横,竖,横折,横
酯	横,竖,横折,撇,竖弯,横,横,撇,竖弯钩,竖,横折,横,横
酰	横,竖,横折,撇,竖弯,横,横,撇,横,竖,横,撇,竖弯钩
酱	点,提,竖,撇,横撇|横钩,点,横,竖,横折,撇,竖弯,横,横
酲	横,竖,横折,撇,竖弯,横,横,竖,横折,横,横,横,竖,横
酴	横,竖,横折,撇,竖弯,横,横,撇,捺,横,横,竖钩,撇,点
酵	横,竖,横折,撇,竖弯,横,横,横,竖,横,撇,横撇|横钩,竖钩,横
酶	横,竖,横折,撇,竖弯,横,横,撇,横,竖弯,横折钩,点,横,点
酷	横,竖,横折,撇,竖弯,横,横,撇,横,竖,横,竖,横折,横
酸	横,竖,横折,撇,竖弯,横,横,撇折,点,撇,点,撇,横撇|横钩,捺
酹	横,竖,横折,撇,竖弯,横,横,撇,点,点,撇,横,竖钩,点
酺	
酽	横,竖,横折,撇,竖弯,横,横,横,竖,竖,点,撇,横,撇
酾	横,竖,横折,撇,竖弯,横,横,横,竖,横折钩,点,竖,横折钩,点
酿	横,竖,横折,撇,竖弯,横,横,点,横折,横,横,竖提,撇,捺
醅	横,竖,横折,撇,竖弯,横,横,点,横,点,撇,横,竖,横折,横
醇	横,竖,横折,撇,竖弯,横,横,点,横,竖,横折,横,横撇|横钩,竖钩,横
醉	横,竖,横折,撇,竖弯,横,横,点,横,撇,点,撇,点,横,竖
醋	横,竖,横折,撇,竖弯,横,横,横,竖,竖,横,竖,横折,横,横
醌	横,竖,横折,撇,竖弯,横,横,竖,横折,横,横,横,竖提,撇,竖弯钩
醍	横,竖,横折,撇,竖弯,横,横,竖,横折,横,横,横,竖,横,撇,捺
醐	横,竖,横折,撇,竖弯,横,横,横,竖,竖,横折,横,撇,横折钩,横,横
醑	横,竖,横折,撇,竖弯,横,横,横撇|横钩,竖,横,撇,捺,竖,横折钩,横,横
醒	横,竖,横折,撇,竖弯,横,横,竖,横折,横,横,撇,横,横,竖,横
醚	横,竖,横折,撇,竖弯,横,横,点,撇,横,竖,撇,点,点,横折折撇,捺
醛	横,竖,横折,撇,竖弯,横,横,横,竖,竖,撇,捺,横,横,竖,横
醢	横,竖,横折,撇,竖弯,横,横,横,撇,竖,横折,横,竖,横折,竖,竖,横
醨	
醪	横,竖,横折,撇,竖弯,横,横,横折,点,提,横折,点,提,撇,捺,撇,撇,撇
醭	横,竖,横折,撇,竖弯,横,横,竖,竖,点,撇,横,点,撇,横,横,横,撇,捺
醮	横,竖,横折,撇,竖弯,横,横,撇,竖,点,横,横,横,竖,横,点2,点,点,点
醯	横,竖,横折,撇,竖弯,横,横,点,横,撇折,点,撇,竖,竖弯钩,竖,横折,竖,竖,横
醴	横,竖,横折,撇,竖弯,横,横,竖,横折,横,竖,竖,横,横,竖,横折,横,点,撇,横
醵	横,竖,横折,撇,竖弯,横,横,竖,横,横撇|横钩,撇,横,竖弯钩,横,撇,弯钩,撇,撇,撇,捺
醺	横,竖,横折,撇,竖弯,横,横,撇,横,竖,横折,点,撇,横,竖,横,横,点2,点,点,点
醾	
采	撇,点,点,撇,横,竖,撇,捺
釉	撇,点,撇,横,竖,撇,点,竖,横折,横,竖,横
释	撇,点,撇,横,竖,撇,点,横撇|横钩,捺,横,横,竖
里	竖,横折,横,横,竖,横,横
重	撇,横,竖,横折,横,横,竖,横,横
野	竖,横折,横,横,竖,横,提,横撇|横钩,点,横撇|横钩,竖钩
量	竖,横折,横,横,横,竖,横折,横,横,竖,横,横
釐	横,横,竖,撇,点,撇,横,撇,捺,横,撇,竖,横折,横,横,竖,横,横
金	撇,捺,横,横,竖,点,撇,横
釜	撇,点,撇,捺,横,横,竖,点,撇,横
鉴	竖,竖,撇,横,点,撇,捺,横,横,竖,点,撇,横
銎	横,竖,提,撇,横斜钩,点,撇,捺,横,横,竖,点,撇,横
銮	点,横,竖,竖,撇,点,撇,捺,横,横,竖,点,撇,横
鋆	横,竖,提,撇,横折钩,点,提,撇,捺,横,横,竖,点,撇,横
鋈	点,点,提,撇,横,撇,点,撇,捺,横,横,竖,点,撇,横
錾	横,撇折,竖,提,撇,撇,横,竖,撇,捺,横,横,竖,点,撇,横
鍪	横撇|横钩,点,横撇|横钩,竖钩,撇,撇,横,撇,点,撇,捺,横,横,竖,点,撇,横
鎏	点,点,提,点,横,撇折,点,撇,竖,竖弯钩,撇,捺,横,横,竖,点,撇,横
鏊	横,横,竖,横,横折钩,撇,撇,横,撇,点,撇,捺,横,横,竖,点,撇,横
鏖	点,横,撇,横折,竖,竖,横,横,竖提,撇,竖弯钩,撇,捺,横,横,竖,点,撇,横
鐾	横折,横,撇,竖,横折,横,点,横,点,撇,横,横,竖,撇,捺,横,横,竖,点,撇,横
鑫	撇,捺,横,横,竖,点,撇,横,撇,捺,横,横,竖,点,撇,提,撇,捺,横,横,竖,点,撇,横
钆	撇,横,横,横,竖提,竖弯钩
钇	撇,横,横,横,竖提,横斜钩
针	撇,横,横,横,竖提,横,竖
钉	撇,横,横,横,竖提,横,竖钩
钊	撇,横,横,横,竖提,竖,竖钩
钋	撇,横,横,横,竖提,竖,点
钌	撇,横,横,横,竖提,横撇|横钩,竖钩
钍	撇,横,横,横,竖提,横,竖,横
钎	撇,横,横,横,竖提,撇,横,竖
钏	撇,横,横,横,竖提,撇,竖,竖
钐	撇,横,横,横,竖提,撇,撇,撇
钒	撇,横,横,横,竖提,撇,横斜钩,点
钓	撇,横,横,横,竖提,撇,横折钩,点
钔	撇,横,横,横,竖提,点,竖,横折钩
钕	撇,横,横,横,竖提,撇点,撇,横
钖	
钗	撇,横,横,横,竖提,横撇|横钩,捺,点
钘	
钙	撇,横,横,横,竖提,横,竖,横,竖折折钩
钚	撇,横,横,横,竖提,横,撇,竖,点
钛	撇,横,横,横,竖提,横,撇,捺,点
钜	撇,横,横,横,竖提,横,横折,横,竖弯
钝	撇,横,横,横,竖提,横,竖弯,竖,竖弯钩
钞	撇,横,横,横,竖提,竖,撇,点,撇
钟	撇,横,横,横,竖提,竖,横折,横,竖
钠	撇,横,横,横,竖提,竖,横折钩,撇,点
钡	撇,横,横,横,竖提,竖,横折,撇,点
钢	撇,横,横,横,竖提,竖,横折钩,撇,点
钣	撇,横,横,横,竖提,撇,撇,横撇|横钩,捺
钤	撇,横,横,横,竖提,撇,捺,点,横撇|横钩
钥	撇,横,横,横,竖提,撇,横折钩,横,横
钦	撇,横,横,横,竖提,撇,横撇|横钩,撇,捺
钧	撇,横,横,横,竖提,撇,横折钩,点,提
钨	撇,横,横,横,竖提,撇,横折钩,竖折折钩,横
钩	撇,横,横,横,竖提,撇,横折钩,撇折,点
钪	撇,横,横,横,竖提,点,横,撇,横斜钩
钫	撇,横,横,横,竖提,点,横,横折钩,撇
钬	撇,横,横,横,竖提,点2,撇,撇,捺
钭	撇,横,横,横,竖提,点,点,横,竖
钮	撇,横,横,横,竖提,横折,竖,横,横
钯	撇,横,横,横,竖提,横折,竖,横,竖弯钩
钰	撇,横,横,横,竖提,横,横,竖,横,点
钱	撇,横,横,横,竖提,横,横,斜钩|卧钩,撇,点
钲	撇,横,横,横,竖提,横,竖,横,竖,横
钳	撇,横,横,横,竖提,横,竖,竖,横,横
钴	撇,横,横,横,竖提,横,竖,竖,横折,横
钵	撇,横,横,横,竖提,横,竖,撇,捺,横
钷	撇,横,横,横,竖提,横,竖,横折,横,竖弯
钹	撇,横,横,横,竖提,横,撇,横撇|横钩,捺,点
钺	撇,横,横,横,竖提,横,竖提,斜钩|卧钩,撇,点
钻	撇,横,横,横,竖提,竖,横,竖,横折,横
钼	撇,横,横,横,竖提,竖,横折,横,横,横
钽	撇,横,横,横,竖提,竖,横折,横,横,横
钾	撇,横,横,横,竖提,竖,横折,横,横,竖
钿	撇,横,横,横,竖提,竖,横折,横,竖,横
铀	撇,横,横,横,竖提,竖,横折,横,竖,横
铁	撇,横,横,横,竖提,撇,横,横,撇,捺
铂	撇,横,横,横,竖提,撇,竖,横折,横,横
铃	撇,横,横,横,竖提,撇,捺,点,横撇|横钩,点
铄	撇,横,横,横,竖提,撇,竖弯,竖钩,撇,点
铅	撇,横,横,横,竖提,撇,横折折|横折弯,竖,横折,横
铆	撇,横,横,横,竖提,撇,竖提,撇,横折钩,竖
铈	撇,横,横,横,竖提,点,横,竖,横折钩,竖
铉	撇,横,横,横,竖提,点,横,撇折,撇折,点
铊	撇,横,横,横,竖提,点,点2,横撇|横钩,撇,竖弯钩
铋	撇,横,横,横,竖提,点2,斜钩|卧钩,点,撇,点
铌	撇,横,横,横,竖提,横折,横,撇,撇,竖弯钩
铍	撇,横,横,横,竖提,横撇|横钩,撇,竖,横撇|横钩,捺
铎	撇,横,横,横,竖提,横撇|横钩,捺,横,横,竖
铏	
铐	撇,横,横,横,竖提,横,竖,横,撇,横,竖折折钩
铑	撇,横,横,横,竖提,横,竖,横,撇,撇,竖弯钩
铒	撇,横,横,横,竖提,横,竖,竖,横,横,横
铕	撇,横,横,横,竖提,横,撇,竖,横折钩,横,横
铖	撇,横,横,横,竖提,横,撇,横折钩,斜钩|卧钩,撇,点
铗	撇,横,横,横,竖提,横,点,撇,横,撇,捺
铘	撇,横,横,横,竖提,横,撇折,竖钩,撇,横折折折钩|横撇弯钩,竖
铙	撇,横,横,横,竖提,横,斜钩|卧钩,撇,横,撇,竖弯钩
铚	
铛	撇,横,横,横,竖提,竖,点,撇,横折,横,横
铜	撇,横,横,横,竖提,竖,横折钩,横,竖,横折,横
铝	撇,横,横,横,竖提,竖,横折,横,竖,横折,横
铞	撇,横,横,横,竖提,竖,横折,横,竖,横折钩,竖
铟	撇,横,横,横,竖提,竖,横折,横,撇,点,横
铠	撇,横,横,横,竖提,竖,竖弯,竖,横折,横,竖弯钩
铡	撇,横,横,横,竖提,竖,横折,撇,点,竖,竖钩
铢	撇,横,横,横,竖提,撇,横,横,竖,撇,捺
铣	撇,横,横,横,竖提,撇,横,竖,横,撇,竖弯钩
铤	撇,横,横,横,竖提,撇,横,竖,横,横折折撇,捺
铥	撇,横,横,横,竖提,撇,横,竖,横,撇折,点
铧	撇,横,横,横,竖提,撇,竖,撇,竖弯钩,横,竖
铨	撇,横,横,横,竖提,撇,捺,横,横,竖,横
铩	撇,横,横,横,竖提,撇,点,横,竖钩,撇,点
铪	撇,横,横,横,竖提,撇,捺,横,竖,横折,横
铫	撇,横,横,横,竖提,撇,点,提,竖弯钩,撇,点
铬	撇,横,横,横,竖提,撇,横撇|横钩,捺,竖,横折,横
铭	撇,横,横,横,竖提,撇,横撇|横钩,点,竖,横折,横
铮	撇,横,横,横,竖提,撇,横撇|横钩,横折,横,横,竖钩
铯	撇,横,横,横,竖提,撇,横撇|横钩,横折,竖,横,竖弯钩
铰	撇,横,横,横,竖提,点,横,撇,点,撇,捺
铱	撇,横,横,横,竖提,点,横,撇,竖提,撇,捺
铲	撇,横,横,横,竖提,点,横,点,撇,横,撇
铳	撇,横,横,横,竖提,点,横,撇折,点,撇,竖弯钩
铴	撇,横,横,横,竖提,点,点,提,横折折折钩|横撇弯钩,撇,撇
铵	撇,横,横,横,竖提,点,点2,横撇|横钩,撇点,撇,横
银	撇,横,横,横,竖提,横折,横,横,竖提,撇,捺
铷	撇,横,横,横,竖提,撇点,撇,横,竖,横折,横
铸	撇,横,横,横,竖提,横,横,横,撇,横,竖钩,点
铹	撇,横,横,横,竖提,横,竖,竖,点2,横撇|横钩,横折钩,撇
铺	撇,横,横,横,竖提,横,竖,横折钩,横,横,竖,点
铻	
铼	撇,横,横,横,竖提,横,点,撇,横,竖,撇,捺
铽	撇,横,横,横,竖提,横,点2,斜钩|卧钩,点,点,斜钩|卧钩,点
链	撇,横,横,横,竖提,横,撇折,横,竖,点,横折折撇,捺
铿	撇,横,横,横,竖提,竖,竖,横撇|横钩,捺,横,竖,横
销	撇,横,横,横,竖提,竖,点,撇,竖,横折钩,横,横
锁	撇,横,横,横,竖提,竖,点,撇,竖,横折,撇,点
锂	撇,横,横,横,竖提,竖,横折,横,横,竖,横,横
锃	撇,横,横,横,竖提,竖,横折,横,横,横,竖,横
锄	撇,横,横,横,竖提,竖,横折,横,横,提,横折钩,撇
锅	撇,横,横,横,竖提,竖,横折,横,竖,横折钩,撇,点
锆	撇,横,横,横,竖提,撇,横,竖,横,竖,横折,横
锇	撇,横,横,横,竖提,撇,横,竖钩,提,斜钩|卧钩,撇,点
锈	撇,横,横,横,竖提,撇,横,竖,撇,捺,横折折折钩|横撇弯钩,撇
锉	撇,横,横,横,竖提,撇,点,撇,点,横,竖,横
锊	撇,横,横,横,竖提,撇,点,点,撇,横,竖钩,点
锋	撇,横,横,横,竖提,撇,横撇|横钩,捺,横,横,横,竖
锌	撇,横,横,横,竖提,点,横,点,撇,横,横,竖
锍	撇,横,横,横,竖提,点,横,撇折,点,撇,竖,竖弯钩
锎	撇,横,横,横,竖提,点,竖,横折钩,横,横,撇,竖
锏	撇,横,横,横,竖提,点,竖,横折钩,竖,横折,横,横
锐	撇,横,横,横,竖提,点,撇,竖,横折,横,撇,竖弯钩
锑	撇,横,横,横,竖提,点,撇,横折,横,竖折折钩,竖,撇
锒	撇,横,横,横,竖提,点,横折,横,横,竖提,撇,捺
锓	撇,横,横,横,竖提,横折,横,横,点2,横撇|横钩,横撇|横钩,捺
锔	撇,横,横,横,竖提,横折,横,撇,横折钩,竖,横折,横
锕	撇,横,横,横,竖提,横折折折钩|横撇弯钩,竖,横,竖,横折,横,竖钩
锖	撇,横,横,横,竖提,横,横,竖,横,竖,横折钩,横,横
锗	撇,横,横,横,竖提,横,竖,横,撇,竖,横折,横,横
锘	撇,横,横,横,竖提,横,竖,竖,横,撇,竖,横折,横
错	撇,横,横,横,竖提,横,竖,竖,横,竖,横折,横,横
锚	撇,横,横,横,竖提,横,竖,竖,竖,横折,横,竖,横
锛	撇,横,横,横,竖提,横,撇,捺,横,竖,横,撇,竖
锜	
锝	撇,横,横,横,竖提,竖,横折,横,横,横,横,竖钩,点
锞	撇,横,横,横,竖提,竖,横折,横,横,横,竖,撇,捺
锟	撇,横,横,横,竖提,竖,横折,横,横,横,竖提,撇,竖弯钩
锡	撇,横,横,横,竖提,竖,横折,横,横,撇,横折钩,撇,撇
锢	撇,横,横,横,竖提,竖,横折,横,竖,竖,横折,横,横
锣	撇,横,横,横,竖提,竖,横折,竖,竖,横,撇,横撇|横钩,点
锤	撇,横,横,横,竖提,撇,横,竖,横,竖,竖,横,横
锥	撇,横,横,横,竖提,撇,竖,点,横,横,横,竖,横
锦	撇,横,横,横,竖提,撇,竖,横折,横,横,竖,横折钩,竖
锧	
锨	撇,横,横,横,竖提,撇,撇,横,竖,撇,横撇|横钩,撇,捺
锩	撇,横,横,横,竖提,点,撇,横,横,撇,捺,横折钩,竖弯钩
锪	撇,横,横,横,竖提,撇,横折钩,撇,撇,点2,斜钩|卧钩,点,点
锫	撇,横,横,横,竖提,点,横,点,撇,横,竖,横折,横
锬	撇,横,横,横,竖提,点2,撇,撇,点,点2,撇,撇,捺
锭	撇,横,横,横,竖提,点,点2,横撇|横钩,横,竖,横,撇,捺
键	撇,横,横,横,竖提,横折,横,横,横,横,竖,横折折撇,捺
锯	撇,横,横,横,竖提,横折,横,撇,横,竖,竖,横折,横
锰	撇,横,横,横,竖提,横撇|横钩,竖钩,横,竖,横折,竖,竖,横
锱	撇,横,横,横,竖提,撇点,撇点,撇点,竖,横折,横,竖,横
锲	撇,横,横,横,竖提,横,横,横,竖,横折钩,撇,横,撇,捺
锳	
锴	撇,横,横,横,竖提,横,竖提,撇,竖弯钩,撇,竖,横折,横,横
锵	撇,横,横,横,竖提,点,提,竖,撇,横撇|横钩,点,横,竖钩,点
锶	撇,横,横,横,竖提,竖,横折,横,竖,横,点2,斜钩|卧钩,点,点
锷	撇,横,横,横,竖提,竖,横折,横,竖,横折,横,横,横,竖折折钩
锸	撇,横,横,横,竖提,撇,横,竖,撇,竖,横,横折,横,横
锹	撇,横,横,横,竖提,撇,横,竖,撇,点,点2,撇,撇,捺
锺	撇,横,横,横,竖提,撇,横,竖,横折,横,横,横,竖,横
锻	撇,横,横,横,竖提,撇,竖,横,横,提,撇,横折折|横折弯,横撇|横钩,捺
锼	撇,横,横,横,竖提,撇,竖,横,横折,横,横,竖,横撇|横钩,捺
锽	
锾	撇,横,横,横,竖提,撇,点,点,撇,横,横,撇,横撇|横钩,捺
锿	撇,横,横,横,竖提,点,横,竖,横折,横,撇,竖提,撇,捺
镀	撇,横,横,横,竖提,点,横,撇,横,竖,竖,横,横撇|横钩,捺
镁	撇,横,横,横,竖提,点,撇,横,横,竖,横,横,撇,捺
镂	撇,横,横,横,竖提,点,撇,横,竖,撇,捺,撇点,撇,横
镃	
镄	撇,横,横,横,竖提,横折,横,竖折折钩,撇,竖,竖,横折,撇,点
镅	撇,横,横,横,竖提,横折,竖,横,撇,竖,横折,横,横,横
镆	撇,横,横,横,竖提,横,竖,竖,竖,横折,横,横,横,撇,捺
镇	撇,横,横,横,竖提,横,竖,竖,横折,横,横,横,横,撇,点
镈	
镉	撇,横,横,横,竖提,横,竖,横折,横,竖,横折钩,点,撇,横,竖
镊	撇,横,横,横,竖提,横,竖,竖,横,横,横,横撇|横钩,点,横撇|横钩,捺
镋	
镌	撇,横,横,横,竖提,撇,竖,点,横,横,横,竖,横,横折折折钩|横撇弯钩,撇
镍	撇,横,横,横,竖提,撇,竖,横折,横,横,横,横,竖,撇,捺
镎	撇,横,横,横,竖提,撇,捺,横,竖,横折,横,撇,横,横,竖钩
镏	撇,横,横,横,竖提,撇,竖提,点,横折钩,撇,竖,横折,横,竖,横
镐	撇,横,横,横,竖提,点,横,竖,横折,横,竖,横折钩,竖,横折,横
镑	撇,横,横,横,竖提,点,横,点,撇,点2,横撇|横钩,点,横,横折钩,撇
镒	撇,横,横,横,竖提,点,撇,横,撇,点,竖,横折,竖,竖,横
镓	撇,横,横,横,竖提,点,点2,横撇|横钩,横,撇,弯钩,撇,撇,撇,捺
镔	撇,横,横,横,竖提,点,点2,横撇|横钩,撇,竖,横,竖,横,撇,点
镕	撇,横,横,横,竖提,点,点2,横撇|横钩,撇,点,撇,捺,竖,横折,横
镖	撇,横,横,横,竖提,横,竖,横折,竖,竖,横,横,横,竖钩,撇,点
镗	撇,横,横,横,竖提,竖,点,撇,点2,横撇|横钩,竖,横折,横,横,竖,横
镘	撇,横,横,横,竖提,竖,横折,横,横,竖,横折,竖,竖,横,横撇|横钩,捺
镚	
镛	撇,横,横,横,竖提,点,横,撇,横折,横,横,竖,横折钩,横,横,竖
镜	撇,横,横,横,竖提,点,横,点,撇,横,竖,横折,横,横,撇,竖弯钩
镝	撇,横,横,横,竖提,点,横,点,撇,竖,横折钩,横,竖,竖,横折,横
镞	撇,横,横,横,竖提,点,横,横折钩,撇,撇,横,撇,横,横,撇,捺
镠	
镡	撇,横,横,横,竖提,横,竖,横折,竖,竖,横,竖,横折,横,横,横,竖
镢	撇,横,横,横,竖提,横,撇,点,撇,横,竖弯,竖,撇,撇,横撇|横钩,撇,捺
镣	撇,横,横,横,竖提,横,撇,捺,点,撇,竖,横折,横,横,竖钩,撇,点
镤	撇,横,横,横,竖提,竖,竖,点,撇,横,点,撇,横,横,横,撇,捺
镥	撇,横,横,横,竖提,撇,横撇|横钩,竖,横折,横,竖,横,横,竖,横折,横,横
镦	撇,横,横,横,竖提,点,横,竖,横折,横,横撇|横钩,竖钩,提,撇,横,撇,捺
镧	撇,横,横,横,竖提,点,竖,横折钩,横,竖,横折,点,撇,横,竖,撇,点
镨	撇,横,横,横,竖提,点,撇,横,竖,竖,点,撇,横,竖,横折,横,横
镩	撇,横,横,横,竖提,点,点2,横撇|横钩,撇,点,竖,横折,横,竖,横折,横,竖
镪	撇,横,横,横,竖提,横折,横,竖折折钩,竖,横折,横,竖,横折,横,竖,横,点
镫	撇,横,横,横,竖提,横撇|横钩,点,撇,撇,捺,横,竖,横折,横,点,撇,横
镬	撇,横,横,横,竖提,横,竖,竖,撇,竖,点,横,横,横,竖,横,横撇|横钩,捺
镭	撇,横,横,横,竖提,横,点2,横撇|横钩,竖,点,点,点,点,竖,横折,横,竖,横
镮	
镯	撇,横,横,横,竖提,竖,横折,竖,竖,横,撇,横折钩,竖,横折,横,竖,横,点
镰	撇,横,横,横,竖提,点,横,撇,点,撇,横,横折,横,横,竖,竖,撇,捺
镱	撇,横,横,横,竖提,点,横,点,撇,横,竖,横折,横,横,点2,斜钩|卧钩,点,点
镲	撇,横,横,横,竖提,点,点2,横撇|横钩,撇,横撇|横钩,点,点,横撇|横钩,捺,横,横,竖钩,撇,点
镳	撇,横,横,横,竖提,点,横,撇,横折,竖,竖,横,横,竖提,撇,竖弯钩,点2,点,点,点
镴	
镵	
镶	撇,横,横,横,竖提,点,横,竖,横折,横,竖,横折,横,横,横,竖,竖,横,撇,竖提,撇,捺
长	撇,横,竖提,捺
门	点,竖,横折钩
闩	点,竖,横折钩,横
闪	点,竖,横折钩,撇,点
闫	点,竖,横折钩,横,横,横
闭	点,竖,横折钩,横,竖钩,撇
问	点,竖,横折钩,竖,横折,横
闯	点,竖,横折钩,横折,竖折折钩,横
闰	点,竖,横折钩,横,横,竖,横
闱	点,竖,横折钩,横,横,横折钩,竖
闲	点,竖,横折钩,横,竖,撇,点
闳	点,竖,横折钩,横,撇,撇折,点
间	点,竖,横折钩,竖,横折,横,横
闵	点,竖,横折钩,点,横,撇,点
闶	点,竖,横折钩,点,横,撇,横斜钩
闷	点,竖,横折钩,点2,斜钩|卧钩,点,点
闸	点,竖,横折钩,竖,横折,横,横,竖
闹	点,竖,横折钩,点,横,竖,横折钩,竖
闺	点,竖,横折钩,横,竖,横,横,竖,横
闻	点,竖,横折钩,横,竖,竖,横,横,横
闼	点,竖,横折钩,横,撇,点,点,横折折撇,捺
闽	点,竖,横折钩,竖,横折,横,竖,横,点
闾	点,竖,横折钩,竖,横折,横,竖,横折,横
闿	点,竖,横折钩,竖,竖弯,竖,横折,横,竖弯钩
阀	点,竖,横折钩,撇,竖,横,斜钩|卧钩,撇,点
阁	点,竖,横折钩,撇,横撇|横钩,捺,竖,横折,横
阂	点,竖,横折钩,点,横,撇折,撇,撇,点
阃	点,竖,横折钩,竖,横折,横,竖,撇,点,横
阄	点,竖,横折钩,撇,横撇|横钩,竖,横折,横,横,竖弯钩
阅	点,竖,横折钩,点,撇,竖,横折,横,撇,竖弯钩
阆	点,竖,横折钩,点,横折,横,横,竖提,撇,点
阇	
阈	点,竖,横折钩,横,竖,横折,横,提,斜钩|卧钩,撇,点
阉	点,竖,横折钩,横,撇,捺,竖,横折,横,横,竖弯钩
阊	点,竖,横折钩,竖,横折,横,横,竖,横折,横,横
阋	点,竖,横折钩,撇,竖,横,横折,横,横,撇,竖弯钩
阌	点,竖,横折钩,撇,点,点,撇,点2,横撇|横钩,横撇|横钩,点
阍	点,竖,横折钩,撇,竖提,横,斜钩|卧钩,竖,横折,横,横
阎	点,竖,横折钩,撇,横撇|横钩,撇,竖,横,横折,横,横
阏	点,竖,横折钩,点,横,横折钩,撇,撇,捺,点,点
阐	点,竖,横折钩,点,撇,竖,横折,横,横,横,竖
阑	点,竖,横折钩,横,竖,横折,点,撇,横,竖,撇,点
阒	点,竖,横折钩,竖,横折,横,横,横,横,撇,点,点
阔	点,竖,横折钩,点,点,提,撇,横,竖,竖,横折,横
阕	点,竖,横折钩,横撇|横钩,点,撇,撇,捺,横,横,撇,点
阖	点,竖,横折钩,横,竖,横,撇折,点,竖,横折,竖,竖,横
阗	点,竖,横折钩,横,竖,竖,横折,横,横,横,横,撇,点
阘	
阙	点,竖,横折钩,点,撇,横,竖弯,竖,撇,撇,横撇|横钩,撇,点
阚	点,竖,横折钩,横撇|横钩,横,竖,竖,横,横,提,撇,横,撇,点
阜	撇,竖,横折,横,横折,横,横,竖
队	横折折折钩|横撇弯钩,竖,撇,捺
阡	横折折折钩|横撇弯钩,竖,撇,横,竖
阪	横折折折钩|横撇弯钩,竖,撇,撇,横撇|横钩,捺
阮	横折折折钩|横撇弯钩,竖,横,横,撇,竖弯钩
阱	横折折折钩|横撇弯钩,竖,横,横,撇,竖
防	横折折折钩|横撇弯钩,竖,点,横,横折钩,撇
阳	横折折折钩|横撇弯钩,竖,竖,横折,横,横
阴	横折折折钩|横撇弯钩,竖,撇,横折钩,横,横
阵	横折折折钩|横撇弯钩,竖,横,撇折,横,竖
阶	横折折折钩|横撇弯钩,竖,撇,捺,撇,竖
阻	横折折折钩|横撇弯钩,竖,竖,横折,横,横,横
阼	横折折折钩|横撇弯钩,竖,撇,横,竖,横,横
阽	横折折折钩|横撇弯钩,竖,竖,横,竖,横折,横
阿	横折折折钩|横撇弯钩,竖,横,竖,横折,横,竖钩
陀	横折折折钩|横撇弯钩,竖,点,点2,横撇|横钩,撇,竖弯钩
陂	横折折折钩|横撇弯钩,竖,横撇|横钩,撇,竖,横撇|横钩,捺
附	横折折折钩|横撇弯钩,竖,撇,竖,横,竖钩,点
际	横折折折钩|横撇弯钩,竖,横,横,竖钩,撇,点
陆	横折折折钩|横撇弯钩,竖,横,横,竖,竖弯,竖
陇	横折折折钩|横撇弯钩,竖,横,撇,竖弯钩,撇,点
陈	横折折折钩|横撇弯钩,竖,横,撇折,竖钩,撇,点
陉	横折折折钩|横撇弯钩,竖,横撇|横钩,点,横,竖,横
陋	横折折折钩|横撇弯钩,竖,横,竖,横折钩,撇,点,竖弯
陌	横折折折钩|横撇弯钩,竖,横,撇,竖,横折,横,横
降	横折折折钩|横撇弯钩,竖,撇,横撇|横钩,捺,横,撇折,竖
陎	
限	横折折折钩|横撇弯钩,竖,横折,横,横,竖提,撇,捺
陑	
陔	横折折折钩|横撇弯钩,竖,点,横,撇折,撇,撇,点
陕	横折折折钩|横撇弯钩,竖,横,点,撇,横,撇,捺
陛	横折折折钩|横撇弯钩,竖,横,竖提,撇,竖弯钩,横,竖,横
陞	横折折折钩|横撇弯钩,竖,撇,横,撇,竖,横,竖,横
陟	横折折折钩|横撇弯钩,竖,竖,横,竖,横,竖,撇,撇
陡	横折折折钩|横撇弯钩,竖,横,竖,横,竖,横,撇,捺
院	横折折折钩|横撇弯钩,竖,点,点2,横撇|横钩,横,横,撇,竖弯钩
除	横折折折钩|横撇弯钩,竖,撇,捺,横,横,竖钩,撇,点
陧	横折折折钩|横撇弯钩,竖,竖,横折,横,横,横,竖,横
陨	横折折折钩|横撇弯钩,竖,竖,横折,横,竖,横折,撇,点
险	横折折折钩|横撇弯钩,竖,撇,捺,横,点,点,撇,横
陪	横折折折钩|横撇弯钩,竖,点,横,点,撇,横,竖,横折,横
陬	横折折折钩|横撇弯钩,竖,横,竖,竖,横,横,提,横撇|横钩,捺
陲	横折折折钩|横撇弯钩,竖,撇,横,竖,横,竖,竖,横,横
陴	横折折折钩|横撇弯钩,竖,撇,竖,横折,横,横,撇,横,竖
陵	横折折折钩|横撇弯钩,竖,横,竖,横,撇,点,撇,横撇|横钩,捺
陶	横折折折钩|横撇弯钩,竖,撇,横折钩,撇,横,横,竖,竖弯,竖
陷	横折折折钩|横撇弯钩,竖,撇,横撇|横钩,撇,竖,横,横折,横,横
隃	
隅	横折折折钩|横撇弯钩,竖,竖,横折,横,横,竖,横折钩,竖,提,点
隆	横折折折钩|横撇弯钩,竖,撇,横撇|横钩,捺,横,撇,横,横,竖,横
隈	横折折折钩|横撇弯钩,竖,竖,横折,横,竖,横,横,竖提,撇,捺
隋	横折折折钩|横撇弯钩,竖,横,撇,横,竖,横,竖,横折钩,横,横
隍	横折折折钩|横撇弯钩,竖,撇,竖,横折,横,横,横,横,竖,横
随	横折折折钩|横撇弯钩,竖,横,撇,竖,横折钩,横,横,点,横折折撇,捺
隐	横折折折钩|横撇弯钩,竖,撇,横撇|横钩,横折,横,横,点2,斜钩|卧钩,点,点
隔	横折折折钩|横撇弯钩,竖,横,竖,横折,横,竖,横折钩,点,撇,横,竖
隗	横折折折钩|横撇弯钩,竖,撇,竖,横折,横,横,撇,竖弯钩,撇折,点
隘	横折折折钩|横撇弯钩,竖,点,撇,横,撇,点,竖,横折,竖,竖,横
隙	横折折折钩|横撇弯钩,竖,竖,撇,点,竖,横折,横,横,竖钩,撇,点
障	横折折折钩|横撇弯钩,竖,点,横,点,撇,横,竖,横折,横,横,横,竖
隧	横折折折钩|横撇弯钩,竖,点,撇,横,撇,弯钩,撇,撇,撇,点,点,横折折撇,捺
隩	
隰	横折折折钩|横撇弯钩,竖,竖,横折,横,横,撇折,撇折,点,撇折,撇折,点,点2,点,点,点
隳	横折折折钩|横撇弯钩,竖,横,撇,横,竖,横,竖,横折钩,横,横,撇,捺,竖钩,点2,点,点
隶	横折,横,横,竖钩,点,提,撇,捺
隹	撇,竖,点,横,横,横,竖,横
隺	
隼	撇,竖,点,横,横,横,竖,横,横,竖
隽	撇,竖,点,横,横,横,竖,横,横折折折钩|横撇弯钩,撇
难	横撇|横钩,点,撇,竖,点,横,横,横,竖,横
雀	竖,撇,点,撇,竖,点,横,横,横,竖,横
雁	横,撇,撇,竖,撇,竖,点,横,横,横,竖,横
雄	横,撇,撇折,点,撇,竖,点,横,横,横,竖,横
雅	横,撇折,竖钩,撇,撇,竖,点,横,横,横,竖,横
集	撇,竖,点,横,横,横,竖,横,横,竖,撇,捺
雇	点,横折,横,撇,撇,竖,点,横,横,横,竖,横
雉	撇,横,横,撇,点,撇,竖,点,横,横,横,竖,横
雊	
雌	竖,横,竖,提,横,竖提,撇,竖,点,横,横,横,竖,横
雍	点,横,撇折,撇折,撇,撇,竖,点,横,横,横,竖,横
雎	竖,横折,横,横,提,撇,竖,点,横,横,横,竖,横
雏	撇,横撇|横钩,横折,横,横,撇,竖,点,横,横,横,竖,横
雒	撇,横撇|横钩,点,竖,横折,横,撇,竖,点,横,横,横,竖,横
雕	撇,横折钩,横,竖,横,竖,横折,横,撇,竖,点,横,横,横,竖,横
雠	撇,竖,点,横,横,横,竖,横,点,横折提,撇,竖,点,横,横,横,竖,横
雨	横,竖,横折钩,竖,点,点,点,点
雩	横,点2,横撇|横钩,竖,点,点,点,点,横,横,竖折折钩
雪	横,点2,横撇|横钩,竖,点,点,点,点,横折,横,横
雯	横,点2,横撇|横钩,竖,点,点,点,点,点,横,撇,捺
雱	
雳	横,点2,横撇|横钩,竖,点,点,点,点,横,撇,横折钩,撇
零	横,点2,横撇|横钩,竖,点,点,点,点,撇,捺,点,横撇|横钩,点
雷	横,点2,横撇|横钩,竖,点,点,点,点,竖,横折,横,竖,横
雹	横,点2,横撇|横钩,竖,点,点,点,点,撇,横折钩,横折,横,竖弯钩
雾	横,点2,横撇|横钩,竖,点,点,点,点,撇,横撇|横钩,捺,横折钩,撇
需	横,点2,横撇|横钩,竖,点,点,点,点,横,撇,竖,横折钩,竖,竖
霁	横,点2,横撇|横钩,竖,点,点,点,点,点,横,撇,捺,撇,竖
霄	横,点2,横撇|横钩,竖,点,点,点,点,竖,点,撇,竖,横折钩,横,横
霅	
霆	横,点2,横撇|横钩,竖,点,点,点,点,撇,横,竖,横,横折折撇,捺
震	横,点2,横撇|横钩,竖,点,点,点,点,横,撇,横,横,竖提,撇,捺
霈	横,点2,横撇|横钩,竖,点,点,点,点,点,点,提,横,竖,横折钩,竖
霉	横,点2,横撇|横钩,竖,点,点,点,点,撇,横,竖弯,横折钩,点,横,点
霍	横,点2,横撇|横钩,竖,点,点,点,点,撇,竖,点,横,横,横,竖,横
霎	横,点2,横撇|横钩,竖,点,点,点,点,点,横,点,撇,横,撇点,撇,横
霏	横,点2,横撇|横钩,竖,点,点,点,点,竖,横,横,横,竖,横,横,横
霓	横,点2,横撇|横钩,竖,点,点,点,点,撇,竖,横,横折,横,横,撇,竖弯钩
霖	横,点2,横撇|横钩,竖,点,点,点,点,横,竖,撇,点,横,竖,撇,捺
霜	横,点2,横撇|横钩,竖,点,点,点,点,横,竖,撇,点,竖,横折,横,横,横
霞	横,点2,横撇|横钩,竖,点,点,点,点,横折,横,竖,横,横,横折,横,横撇|横钩,捺
霨	
霪	横,点2,横撇|横钩,竖,点,点,点,点,点,点,提,撇,点,点,撇,撇,横,竖,横
霭	横,点2,横撇|横钩,竖,点,点,点,点,点,横折提,竖,横折,横,横,撇,横折钩,撇,点,竖弯
霰	横,点2,横撇|横钩,竖,点,点,点,点,横,竖,竖,横,竖,横折钩,横,横,撇,横,撇,捺
露	横,点2,横撇|横钩,竖,点,点,点,点,竖,横折,横,竖,横,竖,提,撇,横撇|横钩,捺,竖,横折,横
霸	横,点2,横撇|横钩,竖,点,点,点,点,横,竖,竖,横,竖,横折,横,横,竖,撇,横折钩,横,横
霹	横,点2,横撇|横钩,竖,点,点,点,点,横折,横,撇,竖,横折,横,点,横,点,撇,横,横,竖
霾	横,点2,横撇|横钩,竖,点,点,点,点,撇,点,点,撇,弯钩,撇,撇,竖,横折,横,横,竖,横,横
青	横,横,竖,横,竖,横折钩,横,横
靓	横,横,竖,横,竖,横折钩,横,横,竖,横折,撇,竖弯钩
靖	点,横,点,撇,提,横,横,竖,横,竖,横折钩,横,横
静	横,横,竖,横,竖,横折钩,横,横,撇,横撇|横钩,横折,横,横,竖钩
靛	横,横,竖,横,竖,横折钩,横,横,点,点2,横撇|横钩,横,竖,横,撇,捺
非	竖,横,横,横,竖,横,横,横
靠	撇,横,竖,横,竖,横折,横,竖,横,横,横,竖,横,横,横
靡	点,横,撇,横,竖,撇,点,横,竖,撇,捺,竖,横,横,横,竖,横,横,横
面	横,撇,竖,横折,竖,竖,横,横,横
靥	横,撇,横,撇,捺,点,横,撇,竖,横折,竖,竖,横,横,横
革	横,竖,竖,横,竖,横折,横,横,竖
靬	
靰	
靳	横,竖,竖,横,竖,横折,横,横,竖,撇,撇,横,竖
靴	横,竖,竖,横,竖,横折,横,横,竖,撇,竖,撇,竖弯钩
靶	横,竖,竖,横,竖,横折,横,横,竖,横折,竖,横,竖弯钩
靸	
靺	
靼	横,竖,竖,横,竖,横折,横,横,竖,竖,横折,横,横,横
靽	
靿	
鞁	
鞅	横,竖,竖,横,竖,横折,横,横,竖,竖,横折,横,撇,捺
鞋	横,竖,竖,横,竖,横折,横,横,竖,横,竖,横,横,竖,横
鞍	横,竖,竖,横,竖,横折,横,横,竖,点,点2,横撇|横钩,撇点,撇,横
鞑	横,竖,竖,横,竖,横折,横,横,竖,横,撇,点,点,横折折撇,捺
鞒	横,竖,竖,横,竖,横折,横,横,竖,撇,横,撇,捺,撇,竖
鞔	横,竖,竖,横,竖,横折,横,横,竖,撇,横撇|横钩,竖,横折,横,撇,竖弯钩
鞘	横,竖,竖,横,竖,横折,横,横,竖,竖,点,撇,竖,横折钩,横,横
鞠	横,竖,竖,横,竖,横折,横,横,竖,撇,横折钩,点,撇,横,竖,撇,点
鞡	
鞣	横,竖,竖,横,竖,横折,横,横,竖,横撇|横钩,点,横撇|横钩,竖钩,撇,横,竖,撇,捺
鞧	
鞨	
鞫	横,竖,竖,横,竖,横折,横,横,竖,撇,横折钩,点,横,横,横,竖,横折,横
鞬	
鞭	横,竖,竖,横,竖,横折,横,横,竖,撇,竖,横,竖,横折,横,横,撇,捺
鞮	
鞯	横,竖,竖,横,竖,横折,横,横,竖,横,竖,竖,横,撇,竖,横撇|横钩,竖钩,横
鞲	横,竖,竖,横,竖,横折,横,横,竖,横,横,竖,竖,横,竖,横折钩,竖,横,横
鞳	
鞴	横,竖,竖,横,竖,横折,横,横,竖,横,竖,竖,横,撇,竖,横折钩,横,横,竖
韂	
韦	横,横,横折钩,竖
韧	横,横,横折钩,竖,横折钩,撇,点2
韨	
韩	横,竖,竖,横折,横,横,横,竖,横,横,横折钩,竖
韪	竖,横折,横,横,横,竖,横,撇,捺,横,横,横折钩,竖
韫	横,横,横折钩,竖,竖,横折,横,横,竖,横折,竖,竖,横
韬	横,横,横折钩,竖,撇,点,点,撇,撇,竖,横,横折,横,横
韭	竖,横,横,横,竖,横,横,横,横
音	点,横,点,撇,横,竖,横折,横,横
韵	点,横,点,撇,横,竖,横折,横,横,撇,横折钩,点,提
韶	点,横,点,撇,横,竖,横折,横,横,横折钩,撇,竖,横折,横
页	横,撇,竖,横折,撇,点
顶	横,竖钩,横,撇,竖,横折,撇,点
顷	横,竖提,横,撇,竖,横折,撇,点
顸	横,横,竖,横,撇,竖,横折,撇,点
项	横,竖,提,横,撇,竖,横折,撇,点
顺	撇,竖,竖,横,撇,竖,横折,撇,点
须	撇,撇,撇,横,撇,竖,横折,撇,点
顼	横,横,竖,提,横,撇,竖,横折,撇,点
顽	横,横,撇,竖提,横,撇,竖,横折,撇,点
顾	横,撇,横折钩,竖提,横,撇,竖,横折,撇,点
顿	横,竖弯,竖,竖提,横,撇,竖,横折,撇,点
颀	撇,撇,横,竖,横,撇,竖,横折,撇,点
颁	撇,点,横折钩,撇,横,撇,竖,横折,撇,点
颂	撇,点,撇折,点,横,撇,竖,横折,撇,点
颃	点,横,撇,横折提,横,撇,竖,横折,撇,点
预	横撇|横钩,点,横撇|横钩,竖钩,横,撇,竖,横折,撇,点
颅	竖,横,横折,横,撇,横,撇,竖,横折,撇,点
领	撇,点,点,横撇|横钩,点,横,撇,竖,横折,撇,点
颇	横撇|横钩,撇,竖,横撇|横钩,点,横,撇,竖,横折,撇,点
颈	横撇|横钩,点,横,竖,提,横,撇,竖,横折,撇,点
颉	横,竖,横,竖,横折,横,横,撇,竖,横折,撇,点
颊	横,点,撇,横,撇,点,横,撇,竖,横折,撇,点
颋	
颌	撇,点,横,竖,横折,横,横,撇,竖,横折,撇,点
颍	撇,竖弯钩,竖钩,横撇|横钩,撇,点,横,撇,竖,横折,撇,点
颎	
颏	点,横,撇折,撇,撇,点,横,撇,竖,横折,撇,点
颐	横,竖,竖,横折,横,竖,竖弯,横,撇,竖,横折,撇,点
频	竖,横,竖,横,竖,撇,撇,横,撇,竖,横折,撇,点
颓	撇,横,竖,撇,点,撇,横折提,横,撇,竖,横折,撇,点
颔	撇,点,点,横撇|横钩,竖,横折,横,横,撇,竖,横折,撇,点
颖	撇,竖弯钩,撇,横,竖,撇,点,横,撇,竖,横折,撇,点
颗	竖,横折,横,横,横,竖,撇,点,横,撇,竖,横折,撇,点
题	竖,横折,横,横,横,竖,横,撇,捺,横,撇,竖,横折,撇,点
颙	
颚	竖,横折,横,竖,横折,横,横,横,竖折折钩,横,撇,竖,横折,撇,点
颛	竖,竖弯,竖,横,撇,竖,横折钩,竖,竖,横,撇,竖,横折,撇,点
颜	点,横,点,撇,横,撇,撇,撇,撇,横,撇,竖,横折,撇,点
额	点,点2,横撇|横钩,撇,横撇|横钩,点,竖,横折,横,横,撇,竖,横折,撇,点
颞	横,竖,竖,横,横,横,横撇|横钩,点,横撇|横钩,点,横,撇,竖,横折,撇,点
颟	横,竖,竖,横,竖,横折钩,撇,点,撇,点,横,撇,竖,横折,撇,点
颠	横,竖,竖,横折,横,横,横,横,撇,点,横,撇,竖,横折,撇,点
颡	横撇|横钩,点,横撇|横钩,点,横撇|横钩,点,横,竖,撇,点,横,撇,竖,横折,撇,点
颢	竖,横折,横,横,点,横,竖,横折,横,竖钩,撇,点,横,撇,竖,横折,撇,点
颤	点,横,竖,横折,竖,横折,横,横,竖,横折,横,横,提,横,撇,竖,横折,撇,点
颥	横,点2,横撇|横钩,竖,点,点,点,点,横,撇,竖,横折钩,竖,竖,横,撇,竖,横折,撇,点
颦	竖,横,竖,横,竖,撇,撇,横,撇,竖,横折,撇,点,撇,竖,横折,横,横,撇,横,竖
颧	横,竖,竖,竖,横折,横,竖,横折,横,撇,竖,点,横,横,横,竖,横,横,撇,竖,横折,撇,点
风	撇,横斜钩,撇,点
飏	撇,横斜钩,撇,点,横折折折钩|横撇弯钩,撇,撇
飐	
飑	撇,横斜钩,撇,点,撇,横折钩,横折,横,竖弯钩
飒	点,横,点,撇,提,撇,横斜钩,撇,点
飓	撇,横斜钩,撇,点,竖,横折,横,横,横,横,撇,点
飔	
飕	撇,横斜钩,撇,点,撇,竖,横,横折,横,横,竖,横撇|横钩,点
飗	
飘	横,竖,横折,竖,竖,横,横,横,竖钩,撇,点,撇,横斜钩,撇,点
飙	横,撇,点,点,横,撇,点,点,横,撇,点,点,撇,横斜钩,撇,点
飞	横斜钩,撇,点
食	撇,捺,点,横折,横,横,竖提,撇,点
飧	撇,横撇|横钩,点,撇,捺,点,横折,横,横,竖提,撇,捺
飨	撇折,撇折,撇,撇,捺,点,横折,横,横,竖提,撇,点
餍	横,撇,横,撇,点,点,撇,捺,点,横折,横,横,竖提,撇,点
餐	竖,横,撇,横撇|横钩,点,横撇|横钩,点,撇,捺,点,横折,横,横,竖提,撇,点
餮	横,撇,横撇|横钩,点,撇,捺,撇,撇,撇,撇,捺,点,横折,横,横,竖提,撇,点
饔	点,横,撇折,撇折,撇,撇,竖,点,横,横,横,竖,横,撇,捺,点,横折,横,横,竖提,撇,点
饕	竖,横折,横,横,竖折折钩,竖,横,横撇|横钩,撇,横,竖弯钩,撇,横斜钩,撇,捺,点,横折,横,横,竖提,撇,点
饥	撇,横撇|横钩,竖提,撇,横斜钩
饧	撇,横撇|横钩,竖提,横折折折钩|横撇弯钩,撇,撇
饨	撇,横撇|横钩,竖提,横,竖弯,竖,竖弯钩
饩	撇,横撇|横钩,竖提,撇,横,横,横斜钩
饪	撇,横撇|横钩,竖提,撇,横,竖,横
饫	撇,横撇|横钩,竖提,撇,横,撇,捺
饬	撇,横撇|横钩,竖提,撇,横,横折钩,撇
饭	撇,横撇|横钩,竖提,撇,撇,横撇|横钩,捺
饮	撇,横撇|横钩,竖提,撇,横撇|横钩,撇,捺
饯	撇,横撇|横钩,竖提,横,横,斜钩|卧钩,撇,点
饰	撇,横撇|横钩,竖提,撇,横,竖,横折钩,竖
饱	撇,横撇|横钩,竖提,撇,横折钩,横折,横,竖弯钩
饲	撇,横撇|横钩,竖提,横折钩,横,竖,横折,横
饳	
饴	撇,横撇|横钩,竖提,撇折,点,竖,横折,横
饵	撇,横撇|横钩,竖提,横,竖,竖,横,横,横
饶	撇,横撇|横钩,竖提,横,斜钩|卧钩,撇,横,撇,竖弯钩
饷	撇,横撇|横钩,竖提,撇,竖,横折钩,竖,横折,横
饸	撇,横撇|横钩,竖提,撇,捺,横,竖,横折,横
饹	撇,横撇|横钩,竖提,撇,横撇|横钩,捺,竖,横折,横
饺	撇,横撇|横钩,竖提,点,横,撇,点,撇,捺
饻	
饼	撇,横撇|横钩,竖提,点,撇,横,横,撇,竖
饽	撇,横撇|横钩,竖提,横,竖,点2,横撇|横钩,横撇|横钩,竖钩,横
饿	撇,横撇|横钩,竖提,撇,横,竖钩,提,斜钩|卧钩,撇,点
馁	撇,横撇|横钩,竖提,撇,点,点,撇,撇点,撇,横
馃	撇,横撇|横钩,竖提,竖,横折,横,横,横,竖,撇,捺
馄	撇,横撇|横钩,竖提,竖,横折,横,横,横,竖提,撇,竖弯钩
馅	撇,横撇|横钩,竖提,撇,横撇|横钩,撇,竖,横,横折,横,横
馆	撇,横撇|横钩,竖提,点,点2,横撇|横钩,竖,横折,横,横折,横
馇	撇,横撇|横钩,竖提,横,竖,撇,捺,竖,横折,横,横,横
馈	撇,横撇|横钩,竖提,竖,横折,横,竖,横,竖,横折,撇,点
馉	
馊	撇,横撇|横钩,竖提,撇,竖,横,横折,横,横,竖,横撇|横钩,捺
馋	撇,横撇|横钩,竖提,撇,横撇|横钩,竖,横折,横,撇,竖弯钩,点,点
馌	
馍	撇,横撇|横钩,竖提,横,竖,竖,竖,横折,横,横,横,撇,捺
馏	撇,横撇|横钩,竖提,撇,竖提,点,横折钩,撇,竖,横折,横,竖,横
馐	撇,横撇|横钩,竖提,点,撇,横,横,横,撇,横折,竖,横,横
馑	撇,横撇|横钩,竖提,横,竖,竖,横,竖,横折,横,横,横,竖,横
馒	撇,横撇|横钩,竖提,竖,横折,横,横,竖,横折,竖,竖,横,横撇|横钩,捺
馓	撇,横撇|横钩,竖提,横,竖,竖,横,竖,横折钩,横,横,撇,横,撇,捺
馔	撇,横撇|横钩,竖提,横折,横,竖提,横折,横,竖弯钩,横,竖,竖,横,撇,点
馕	撇,横撇|横钩,竖提,横,竖,横折,横,竖,点2,横撇|横钩,竖,横折,横,竖,横折,横,横,横,竖,竖,横,撇,竖提,撇,捺
首	点,撇,横,撇,竖,横折,横,横,横
馗	撇,横斜钩,点,撇,横,撇,竖,横折,横,横,横
馘	点,撇,横,撇,竖,横折,横,横,横,横,竖,横折,横,提,斜钩|卧钩,撇,点
香	撇,横,竖,撇,捺,竖,横折,横,横
馝	
馞	
馥	撇,横,竖,撇,点,竖,横折,横,横,撇,横,竖,横折,横,横,撇,横撇|横钩,捺
馧	
馨	横,竖,横,横折,竖,横,撇,撇,横折折|横折弯,横撇|横钩,点,撇,横,竖,撇,捺,竖,横折,横,横
马	横折,竖折折钩,横
驭	横折,竖折折钩,提,横撇|横钩,捺
驮	横折,竖折折钩,提,横,撇,捺
驯	横折,竖折折钩,提,撇,竖,竖
驰	横折,竖折折钩,提,横折钩,竖,竖弯钩
驱	横折,竖折折钩,提,横,撇,点,竖弯
驲	
驳	横折,竖折折钩,提,撇,点,撇,捺
驴	横折,竖折折钩,提,点,横折,横,撇
驵	横折,竖折折钩,提,竖,横折,横,横,横
驶	横折,竖折折钩,提,竖,横折,横,撇,捺
驷	横折,竖折折钩,提,竖,横折,撇,竖弯,横
驸	横折,竖折折钩,提,撇,竖,横,竖钩,点
驹	横折,竖折折钩,提,撇,横折钩,竖,横折,横
驺	横折,竖折折钩,提,撇,横撇|横钩,横折,横,横
驻	横折,竖折折钩,提,点,横,横,竖,横
驼	横折,竖折折钩,提,点,点2,横撇|横钩,撇,竖弯钩
驽	撇点,撇,横,横撇|横钩,捺,横折,竖折折钩,横
驾	横折钩,撇,竖,横折,横,横折,竖折折钩,横
驿	横折,竖折折钩,提,横撇|横钩,捺,横,横,竖
骀	横折,竖折折钩,提,撇折,点,竖,横折,横
骁	横折,竖折折钩,提,横,斜钩|卧钩,撇,横,撇,竖弯钩
骂	竖,横折,横,竖,横折,横,横折,竖折折钩,横
骃	
骄	横折,竖折折钩,提,撇,横,撇,捺,撇,竖
骅	横折,竖折折钩,提,撇,竖,撇,竖弯钩,横,竖
骆	横折,竖折折钩,提,撇,横撇|横钩,捺,竖,横折,横
骇	横折,竖折折钩,提,点,横,撇折,撇,撇,点
骈	横折,竖折折钩,提,点,撇,横,横,撇,竖
骉	
骊	横折,竖折折钩,提,横,竖,横折钩,点,竖,横折钩,点
骋	横折,竖折折钩,提,竖,横折,横,竖,横,横,竖折折钩
验	横折,竖折折钩,提,撇,捺,横,点,点,撇,横
骍	
骎	
骏	横折,竖折折钩,提,撇折,点,撇,点,撇,横撇|横钩,捺
骐	横折,竖折折钩,提,横,竖,竖,横,横,横,撇,点
骑	横折,竖折折钩,提,横,撇,点,横,竖,横折,横,竖钩
骒	横折,竖折折钩,提,竖,横折,横,横,横,竖,撇,捺
骓	横折,竖折折钩,提,撇,竖,点,横,横,横,竖,横
骕	
骖	横折,竖折折钩,提,撇折,点,横,撇,捺,撇,撇,撇
骗	横折,竖折折钩,提,点,横折,横,撇,竖,横折钩,横,竖,竖
骘	横折折折钩|横撇弯钩,竖,竖,横,竖,横,竖,撇,撇,横折,竖折折钩,横
骙	
骚	横折,竖折折钩,提,横撇|横钩,捺,点,竖,横折,横,竖,横,点
骛	横撇|横钩,点,横撇|横钩,竖钩,撇,撇,横,撇,捺,横折,竖折折钩,横
骜	横,横,竖,横,横折钩,撇,撇,横,撇,捺,横折,竖折折钩,横
骝	横折,竖折折钩,提,撇,竖提,点,横折钩,撇,竖,横折,横,竖,横
骞	点,点2,横撇|横钩,横,横,竖,竖,横,撇,捺,横折,竖折折钩,横
骟	横折,竖折折钩,提,点,横折,横,撇,横折钩,点,提,横折钩,点,提
骠	横折,竖折折钩,提,横,竖,横折,竖,竖,横,横,横,竖钩,撇,点
骡	横折,竖折折钩,提,竖,横折,横,竖,横,撇折,撇折,点,竖钩,撇,点
骢	横折,竖折折钩,提,撇,竖,横折,撇,横撇|横钩,点,横,点2,斜钩|卧钩,点,点
骣	横折,竖折折钩,提,横折,横,撇,横撇|横钩,竖钩,横,横撇|横钩,竖钩,提,横撇|横钩,竖钩,横
骤	横折,竖折折钩,提,横,竖,竖,横,横,提,横撇|横钩,点,撇,竖,撇,撇,撇,捺
骥	横折,竖折折钩,提,竖,横,提,撇,竖弯钩,竖,横折,横,竖,横,横,竖,竖,横,撇,点
骦	
骧	横折,竖折折钩,提,点,横,竖,横折,横,竖,横折,横,横,横,竖,竖,横,撇,竖提,撇,捺
骨	竖,横折,横折,点2,横撇|横钩,竖,横折钩,横,横
骰	竖,横折,横折,点2,横撇|横钩,竖,横折钩,横,横,撇,横折折|横折弯,横撇|横钩,捺
骱	竖,横折,横折,点2,横撇|横钩,竖,横折钩,横,横,撇,捺,撇,竖
骶	竖,横折,横折,点2,横撇|横钩,竖,横折钩,横,横,撇,竖提,横,斜钩|卧钩,点
骷	竖,横折,横折,点2,横撇|横钩,竖,横折钩,横,横,横,竖,竖,横折,横
骸	竖,横折,横折,点2,横撇|横钩,竖,横折钩,横,横,点,横,撇折,撇,撇,点
骺	竖,横折,横折,点2,横撇|横钩,竖,横折钩,横,横,撇,撇,横,竖,横折,横
骼	竖,横折,横折,点2,横撇|横钩,竖,横折钩,横,横,撇,横撇|横钩,捺,竖,横折,横
髀	竖,横折,横折,点2,横撇|横钩,竖,横折钩,横,横,撇,竖,横折,横,横,撇,横,竖
髁	竖,横折,横折,点2,横撇|横钩,竖,横折钩,横,横,竖,横折,横,横,横,竖,撇,捺
髂	竖,横折,横折,点2,横撇|横钩,竖,横折钩,横,横,点,点2,横撇|横钩,撇,横撇|横钩,捺,竖,横折,横
髃	
髅	竖,横折,横折,点2,横撇|横钩,竖,横折钩,横,横,点,撇,横,竖,撇,捺,撇点,撇,横
髋	竖,横折,横折,点2,横撇|横钩,竖,横折钩,横,横,点,点2,横撇|横钩,横,竖,竖,竖,横折,撇,竖弯钩
髌	竖,横折,横折,点2,横撇|横钩,竖,横折钩,横,横,点,点2,横撇|横钩,撇,竖,横,竖,横,撇,点
髎	
髑	竖,横折,横折,点2,横撇|横钩,竖,横折钩,横,横,竖,横折,竖,竖,横,撇,横折钩,竖,横折,横,竖,横,点
髓	竖,横折,横折,点2,横撇|横钩,竖,横折钩,横,横,横,撇,横,竖,横,竖,横折钩,横,横,点,横折折撇,捺
高	点,横,竖,横折,横,竖,横折钩,竖,横折,横
髡	横,竖,横,横,横,撇折,点,撇,撇,撇,横,撇,竖弯钩
髢	
髦	横,竖,横,横,横,撇折,点,撇,撇,撇,撇,横,横,竖弯钩
髫	横,竖,横,横,横,撇折,点,撇,撇,撇,横折钩,撇,竖,横折,横
髭	横,竖,横,横,横,撇折,点,撇,撇,撇,竖,横,竖,提,撇,竖弯钩
髯	横,竖,横,横,横,撇折,点,撇,撇,撇,竖,横折钩,竖,横,横
髹	横,竖,横,横,横,撇折,点,撇,撇,撇,撇,竖,横,竖,撇,捺
髻	横,竖,横,横,横,撇折,点,撇,撇,撇,横,竖,横,竖,横折,横
髽	
鬃	横,竖,横,横,横,撇折,点,撇,撇,撇,点,点2,横撇|横钩,横,横,竖钩,撇,点
鬈	横,竖,横,横,横,撇折,点,撇,撇,撇,点,撇,横,横,撇,捺,横折钩,竖弯钩
鬏	横,竖,横,横,横,撇折,点,撇,撇,撇,撇,横,竖,撇,点,点2,撇,撇,捺
鬒	
鬓	横,竖,横,横,横,撇折,点,撇,撇,撇,点,点2,横撇|横钩,撇,竖,横,竖,横,撇,点
鬘	
鬟	横,竖,横,横,横,撇折,点,撇,撇,撇,竖,横折,竖,竖,横,横,竖,横折,横,撇,竖提,撇,捺
鬣	横,竖,横,横,横,撇折,点,撇,撇,撇,撇点,撇点,撇点,竖,横折,撇,点,横,竖提,点,点,竖提,点,点,斜钩|卧钩
鬯	撇,点,点,点,点,点,竖弯,竖,撇,竖弯钩
鬲	横,竖,横折,横,竖,横折钩,点,撇,横,竖
鬶	
鬷	
鬻	横折,横,竖折折钩,点,撇,横,竖,撇,点,横折,横,竖折折钩,横,竖,横折,横,竖,横折钩,点,撇,横,竖
鬼	撇,竖,横折,横,横,撇,竖弯钩,撇折,点
魁	撇,竖,横折,横,横,撇,竖弯钩,撇折,点,点,点,横,竖
魂	横,横,撇折,点,撇,竖,横折,横,横,撇,竖弯钩,撇折,点
魃	撇,竖,横折,横,横,撇,竖弯钩,撇折,点,横,撇,横撇|横钩,点,点
魄	撇,竖,横折,横,横,撇,竖,横折,横,横,撇,竖弯钩,撇折,点
魅	撇,竖,横折,横,横,撇,竖弯钩,撇折,点,横,横,竖,撇,捺
魆	
魇	横,撇,横,撇,捺,点,撇,竖,横折,横,横,撇,竖弯钩,撇折,点
魈	撇,竖,横折,横,横,撇,竖弯钩,撇折,点,竖,点,撇,竖,横折钩,横,横
魉	撇,竖,横折,横,横,撇,竖弯钩,撇折,点,横,竖,横折钩,撇,点,撇,点
魋	
魍	撇,竖,横折,横,横,撇,竖弯钩,撇折,点,竖,横折钩,点,撇,横,点,横,竖弯
魏	撇,横,竖,撇,点,撇点,撇,横,撇,竖,横折,横,横,撇,竖弯钩,撇折,点
魑	撇,竖,横折,横,横,撇,竖弯钩,撇折,点,点,横,撇,点,竖弯,竖,竖,横折钩,撇折,点
魔	点,横,撇,横,竖,撇,点,横,竖,撇,捺,撇,竖,横折,横,横,撇,竖弯钩,撇折,点
鱼	撇,横撇|横钩,竖,横折,横,竖,横,横
鱽	
鱾	
鱿	撇,横撇|横钩,竖,横折,横,竖,横,提,横,撇,竖弯钩,点
鲀	
鲁	撇,横撇|横钩,竖,横折,横,竖,横,横,竖,横折,横,横
鲂	撇,横撇|横钩,竖,横折,横,竖,横,提,点,横,横折钩,撇
鲃	
鲅	撇,横撇|横钩,竖,横折,横,竖,横,提,横,撇,横撇|横钩,捺,点
鲆	撇,横撇|横钩,竖,横折,横,竖,横,提,横,点,撇,横,竖
鲇	撇,横撇|横钩,竖,横折,横,竖,横,提,竖,横,竖,横折,横
鲈	撇,横撇|横钩,竖,横折,横,竖,横,提,竖,横,横折,横,撇
鲉	
鲊	
鲋	撇,横撇|横钩,竖,横折,横,竖,横,提,撇,竖,横,竖钩,点
鲌	
鲍	撇,横撇|横钩,竖,横折,横,竖,横,提,撇,横折钩,横折,横,竖弯钩
鲎	点,点,撇,点2,横撇|横钩,撇,横撇|横钩,竖,横折,横,竖,横,横
鲏	
鲐	撇,横撇|横钩,竖,横折,横,竖,横,提,撇折,点,竖,横折,横
鲑	撇,横撇|横钩,竖,横折,横,竖,横,提,横,竖,横,横,竖,横
鲒	撇,横撇|横钩,竖,横折,横,竖,横,提,横,竖,横,竖,横折,横
鲔	撇,横撇|横钩,竖,横折,横,竖,横,提,横,撇,竖,横折钩,横,横
鲕	撇,横撇|横钩,竖,横折,横,竖,横,提,横,撇,竖,横折钩,竖,竖
鲖	
鲗	
鲘	
鲙	
鲚	撇,横撇|横钩,竖,横折,横,竖,横,提,点,横,撇,捺,撇,竖
鲛	撇,横撇|横钩,竖,横折,横,竖,横,提,点,横,撇,点,撇,捺
鲜	撇,横撇|横钩,竖,横折,横,竖,横,提,点,撇,横,横,横,竖
鲝	
鲞	点,撇,横,横,撇,捺,撇,横撇|横钩,竖,横折,横,竖,横,横
鲟	撇,横撇|横钩,竖,横折,横,竖,横,提,横折,横,横,横,竖钩,点
鲠	撇,横撇|横钩,竖,横折,横,竖,横,提,横,竖,横折,横,横,撇,捺
鲡	撇,横撇|横钩,竖,横折,横,竖,横,提,横,竖,横折钩,点,竖,横折钩,点
鲢	撇,横撇|横钩,竖,横折,横,竖,横,提,横,撇折,横,竖,点,横折折撇,捺
鲣	撇,横撇|横钩,竖,横折,横,竖,横,提,竖,竖,横撇|横钩,捺,横,竖,横
鲤	撇,横撇|横钩,竖,横折,横,竖,横,提,竖,横折,横,横,竖,横,横
鲥	撇,横撇|横钩,竖,横折,横,竖,横,提,竖,横折,横,横,横,竖钩,点
鲦	撇,横撇|横钩,竖,横折,横,竖,横,提,撇,横撇|横钩,捺,横,竖钩,撇,点
鲧	撇,横撇|横钩,竖,横折,横,竖,横,提,撇,撇折,撇折,点,竖钩,撇,点
鲨	点,点,提,竖,撇,点,撇,撇,横撇|横钩,竖,横折,横,竖,横,横
鲩	撇,横撇|横钩,竖,横折,横,竖,横,提,点,点2,横撇|横钩,横,横,撇,竖弯钩
鲪	
鲫	撇,横撇|横钩,竖,横折,横,竖,横,提,横折,横,横,竖提,点,横折钩,竖
鲬	
鲭	撇,横撇|横钩,竖,横折,横,竖,横,提,横,横,竖,横,竖,横折钩,横,横
鲮	撇,横撇|横钩,竖,横折,横,竖,横,提,横,竖,横,撇,点,撇,横撇|横钩,捺
鲯	
鲰	撇,横撇|横钩,竖,横折,横,竖,横,提,横,竖,竖,横,横,提,横撇|横钩,捺
鲱	撇,横撇|横钩,竖,横折,横,竖,横,提,竖,横,横,横,竖,横,横,横
鲲	撇,横撇|横钩,竖,横折,横,竖,横,提,竖,横折,横,横,横,竖提,撇,竖弯钩
鲳	撇,横撇|横钩,竖,横折,横,竖,横,提,竖,横折,横,横,竖,横折,横,横
鲴	撇,横撇|横钩,竖,横折,横,竖,横,提,竖,横折,横,竖,竖,横折,横,横
鲵	撇,横撇|横钩,竖,横折,横,竖,横,提,撇,竖,横,横折,横,横,撇,竖弯钩
鲷	撇,横撇|横钩,竖,横折,横,竖,横,提,撇,横折钩,横,竖,横,竖,横折,横
鲸	撇,横撇|横钩,竖,横折,横,竖,横,提,点,横,竖,横折,横,竖钩,撇,点
鲹	
鲺	撇,横撇|横钩,竖,横折,横,竖,横,提,横斜钩,横,竖,横折,横,竖,横,点
鲻	撇,横撇|横钩,竖,横折,横,竖,横,提,撇点,撇点,撇点,竖,横折,横,竖,横
鲼	撇,横撇|横钩,竖,横折,横,竖,横,提,横,竖,横,竖,竖,竖,横折,撇,点
鲽	撇,横撇|横钩,竖,横折,横,竖,横,提,横,竖,竖,横,竖弯,横,竖,撇,捺
鲾	
鲿	
鳀	
鳁	
鳂	
鳃	撇,横撇|横钩,竖,横折,横,竖,横,提,竖,横折,横,竖,横,点2,斜钩|卧钩,点,点
鳄	撇,横撇|横钩,竖,横折,横,竖,横,提,竖,横折,横,竖,横折,横,横,横,竖折折钩
鳅	撇,横撇|横钩,竖,横折,横,竖,横,提,撇,横,竖,撇,点,点2,撇,撇,捺
鳇	撇,横撇|横钩,竖,横折,横,竖,横,提,撇,竖,横折,横,横,横,横,竖,横
鳈	
鳉	
鳊	撇,横撇|横钩,竖,横折,横,竖,横,提,点,横折,横,撇,竖,横折钩,横,竖,竖
鳌	横,横,竖,横,横折钩,撇,撇,横,撇,捺,撇,横撇|横钩,竖,横折,横,竖,横,横
鳍	撇,横撇|横钩,竖,横折,横,竖,横,提,横,竖,横,撇,撇,竖弯钩,竖,横折,横,横
鳎	撇,横撇|横钩,竖,横折,横,竖,横,提,竖,横折,横,横,横折钩,点,提,横折钩,点,提
鳏	撇,横撇|横钩,竖,横折,横,竖,横,提,竖,横折,竖,竖,横,竖,撇,撇,点,点
鳐	撇,横撇|横钩,竖,横折,横,竖,横,提,撇,点,点,撇,撇,横,横,竖,竖弯,竖
鳑	
鳒	
鳓	撇,横撇|横钩,竖,横折,横,竖,横,提,横,竖,竖,横,竖,横折,横,横,竖,横折钩,撇
鳔	撇,横撇|横钩,竖,横折,横,竖,横,提,横,竖,横折,竖,竖,横,横,横,竖钩,撇,点
鳕	撇,横撇|横钩,竖,横折,横,竖,横,提,横,点2,横撇|横钩,竖,点,点,点,点,横折,横,横
鳖	点,撇,竖,横折钩,竖,撇,点,撇,横,撇,捺,撇,横撇|横钩,竖,横折,横,竖,横,横
鳗	撇,横撇|横钩,竖,横折,横,竖,横,提,竖,横折,横,横,竖,横折,竖,竖,横,横撇|横钩,捺
鳘	撇,横,竖弯,横折,点,横,点,撇,横,撇,捺,撇,横撇|横钩,竖,横折,横,竖,横,横
鳙	撇,横撇|横钩,竖,横折,横,竖,横,提,点,横,撇,横折,横,横,竖,横折钩,横,横,竖
鳚	
鳛	
鳜	撇,横撇|横钩,竖,横折,横,竖,横,提,横,撇,点,撇,横,竖弯,竖,撇,撇,横撇|横钩,撇,捺
鳝	撇,横撇|横钩,竖,横折,横,竖,横,提,点,撇,横,横,横,竖,点,撇,横,竖,横折,横
鳞	撇,横撇|横钩,竖,横折,横,竖,横,提,点,撇,横,竖,撇,捺,撇,横撇|横钩,点,横,撇折,竖
鳟	撇,横撇|横钩,竖,横折,横,竖,横,提,点,撇,横,竖,横折,撇,竖弯,横,横,横,竖钩,点
鳠	
鳡	
鳢	撇,横撇|横钩,竖,横折,横,竖,横,提,竖,横折,横,竖,竖,横,横,竖,横折,横,点,撇,横
鳣	
鳤	
鸟	撇,横折钩,点,竖折折钩,横
鸠	撇,横斜钩,撇,横折钩,点,竖折折钩,横
鸡	横撇|横钩,点,撇,横折钩,点,竖折折钩,横
鸢	横,斜钩|卧钩,点,撇,横折钩,点,竖折折钩,横
鸣	竖,横折,横,撇,横折钩,点,竖折折钩,横
鸤	
鸥	横,撇,点,竖弯,撇,横折钩,点,竖折折钩,横
鸦	横,撇折,竖钩,撇,撇,横折钩,点,竖折折钩,横
鸧	
鸨	撇,竖弯钩,横,竖,撇,横折钩,点,竖折折钩,横
鸩	点2,横撇|横钩,撇,竖提,撇,横折钩,点,竖折折钩,横
鸪	横,竖,竖,横折,横,撇,横折钩,点,竖折折钩,横
鸫	横,撇折,竖钩,撇,点,撇,横折钩,点,竖折折钩,横
鸬	竖,横,横折,横,撇,撇,横折钩,点,竖折折钩,横
鸭	竖,横折,横,横,竖,撇,横折钩,点,竖折折钩,横
鸮	竖,横折,横,横,竖折折钩,撇,横折钩,点,竖折折钩,横
鸯	竖,横折,横,撇,捺,撇,横折钩,点,竖折折钩,横
鸰	
鸱	撇,竖提,横,斜钩|卧钩,点,撇,横折钩,点,竖折折钩,横
鸲	撇,横折钩,竖,横折,横,撇,横折钩,点,竖折折钩,横
鸳	撇,横撇|横钩,点,横折钩,竖弯钩,撇,横折钩,点,竖折折钩,横
鸵	撇,横折钩,点,竖折折钩,提,点,点2,横撇|横钩,撇,竖弯钩
鸶	撇折,撇折,撇折,撇折,横,撇,横折钩,点,竖折折钩,横
鸷	横,竖钩,提,撇,横斜钩,点,撇,横折钩,点,竖折折钩,横
鸸	横,撇,竖,横折钩,竖,竖,撇,横折钩,点,竖折折钩,横
鸹	撇,横,竖,竖,横折,横,撇,横折钩,点,竖折折钩,横
鸺	撇,竖,横,竖,撇,点,撇,横折钩,点,竖折折钩,横
鸻	
鸼	
鸽	撇,点,横,竖,横折,横,撇,横折钩,点,竖折折钩,横
鸾	点,横,竖,竖,撇,点,撇,横折钩,点,竖折折钩,横
鸿	点,点,提,横,竖,提,撇,横折钩,点,竖折折钩,横
鹀	横,竖,撇,点,撇,点,提,撇,横折钩,点,竖折折钩,横
鹁	横,竖,点2,横撇|横钩,横撇|横钩,竖钩,提,撇,横折钩,点,竖折折钩,横
鹂	横,竖,横折钩,点,竖,横折钩,点,撇,横折钩,点,竖折折钩,横
鹃	竖,横折,横,竖,横折钩,横,横,撇,横折钩,点,竖折折钩,横
鹄	撇,横,竖,横,竖,横折,横,撇,横折钩,点,竖折折钩,横
鹅	撇,横,竖钩,提,斜钩|卧钩,撇,点,撇,横折钩,点,竖折折钩,横
鹆	撇,点,撇,点,竖,横折,横,撇,横折钩,点,竖折折钩,横
鹇	点,竖,横折钩,横,竖,撇,点,撇,横折钩,点,竖折折钩,横
鹈	点,撇,横折,横,竖折折钩,竖,撇,撇,横折钩,点,竖折折钩,横
鹉	横,横,竖,横,竖,提,斜钩|卧钩,点,撇,横折钩,点,竖折折钩,横
鹊	横,竖,竖,横,竖,横折,横,横,撇,横折钩,点,竖折折钩,横
鹋	横,竖,竖,竖,横折,横,竖,横,撇,横折钩,点,竖折折钩,横
鹌	横,撇,点,竖,横折,横,横,竖提,撇,横折钩,点,竖折折钩,横
鹍	
鹎	撇,竖,横折,横,横,撇,横,竖,撇,横折钩,点,竖折折钩,横
鹏	撇,横折钩,横,横,撇,横折钩,横,横,撇,横折钩,点,竖折折钩,横
鹐	
鹑	点,横,竖,横折,横,横撇|横钩,竖钩,提,撇,横折钩,点,竖折折钩,横
鹒	
鹔	
鹕	横,竖,竖,横折,横,撇,横折钩,横,横,撇,横折钩,点,竖折折钩,横
鹖	
鹗	竖,横折,横,竖,横折,横,横,横,竖折折钩,撇,横折钩,点,竖折折钩,横
鹘	竖,横折,横折,点2,横撇|横钩,竖,横折钩,横,横,撇,横折钩,点,竖折折钩,横
鹙	
鹚	点,撇,横,撇折,撇折,点,撇折,撇折,点,撇,横折钩,点,竖折折钩,横
鹛	横折,竖,横,撇,竖,横折,横,横,横,撇,横折钩,点,竖折折钩,横
鹜	横撇|横钩,点,横撇|横钩,竖钩,撇,撇,横,撇,捺,撇,横折钩,点,竖折折钩,横
鹝	
鹞	撇,点,点,撇,撇,横,横,竖,竖弯,竖,撇,横折钩,点,竖折折钩,横
鹟	
鹠	
鹡	
鹢	
鹣	点,撇,横,横折,横,横,竖,竖,撇,点,撇,横折钩,点,竖折折钩,横
鹤	点2,横撇|横钩,撇,竖,点,横,横,横,竖,横,撇,横折钩,点,竖折折钩,横
鹦	竖,横折,撇,点,竖,横折,撇,点,撇点,撇,横,撇,横折钩,点,竖折折钩,横
鹧	点,横,撇,横,竖,竖,横,点2,点,点,点,撇,横折钩,点,竖折折钩,横
鹨	横折,点,提,横折,点,提,撇,点,撇,撇,撇,撇,横折钩,点,竖折折钩,横
鹩	横,撇,捺,点,撇,竖,横折,横,横,竖钩,撇,点,撇,横折钩,点,竖折折钩,横
鹪	撇,竖,点,横,横,横,竖,横,点2,点,点,点,撇,横折钩,点,竖折折钩,横
鹫	点,横,竖,横折,横,竖钩,撇,点,横,撇,竖弯钩,点,撇,横折钩,点,竖折折钩,横
鹬	横撇|横钩,点,横撇|横钩,竖钩,撇,竖,横折钩,撇,点,竖,横折,横,撇,横折钩,点,竖折折钩,横
鹭	竖,横折,横,竖,横,竖,提,撇,横撇|横钩,捺,竖,横折,横,撇,横折钩,点,竖折折钩,横
鹮	竖,横折,竖,竖,横,横,竖,横折,横,撇,竖提,撇,点,撇,横折钩,点,竖折折钩,横
鹯	
鹰	点,横,撇,撇,竖,撇,竖,点,横,横,横,竖,横,撇,横折钩,点,竖折折钩,横
鹱	撇,横折钩,点,竖折折钩,提,横,竖,竖,撇,竖,点,横,横,横,竖,横,横撇|横钩,捺
鹲	
鹳	横,竖,竖,竖,横折,横,竖,横折,横,撇,竖,点,横,横,横,竖,横,撇,横折钩,点,竖折折钩,横
鹴	
鹾	竖,横,竖,横折,撇,点,横,点,撇,横,横,横,撇,横,竖,横
鹿	点,横,撇,横折,竖,竖,横,横,竖提,撇,竖弯钩
麀	
麂	点,横,撇,横折,竖,竖,横,横,竖提,撇,竖弯钩,撇,横斜钩
麇	点,横,撇,横折,竖,竖,横,横,竖提,撇,竖弯钩,撇,横,竖,撇,捺
麈	点,横,撇,横折,竖,竖,横,横,竖提,撇,竖弯钩,点,横,横,竖,横
麋	点,横,撇,横折,竖,竖,横,横,竖提,撇,竖弯钩,点,撇,横,竖,撇,捺
麑	
麒	点,横,撇,横折,竖,竖,横,横,竖提,横,竖提,横,竖,竖,横,横,横,撇,点
麓	横,竖,撇,点,横,竖,撇,捺,点,横,撇,横折,竖,竖,横,横,竖提,撇,竖弯钩
麖	
麝	点,横,撇,横折,竖,竖,横,横,竖提,撇,竖弯钩,撇,竖,横折钩,横,横,横,撇,横,竖钩,点
麟	点,横,撇,横折,竖,竖,横,横,竖提,横,竖提,点,撇,横,竖,撇,捺,撇,横撇|横钩,点,横,撇折,竖
麦	横,横,竖,横,撇,横撇|横钩,捺
麸	横,横,竖,横,撇,横撇|横钩,点,横,横,撇,捺
麹	
麻	点,横,撇,横,竖,撇,点,横,竖,撇,捺
麽	点,横,撇,横,竖,撇,点,横,竖,撇,捺,撇,撇折,点
麾	点,横,撇,横,竖,撇,点,横,竖,撇,捺,撇,横,横,竖弯钩
黄	横,竖,竖,横,竖,横折,横,竖,横,撇,点
黇	
黉	点,点,撇,点2,横撇|横钩,横,竖,竖,横,竖,横折,横,竖,横,撇,点
黍	撇,横,竖,撇,点,撇,捺,竖钩,点,提,撇,点
黎	撇,横,竖,撇,点,撇,横折钩,撇,撇,捺,竖钩,点,提,撇,点
黏	撇,横,竖,撇,点,撇,点,竖钩,点,提,点2,点,竖,横,竖,横折,横
黑	竖,横折,点,撇,横,竖,横,横,点2,点,点,点
黔	竖,横折,点,撇,横,竖,横,提,点2,点,点,点,撇,捺,点,横撇|横钩
默	竖,横折,点,撇,横,竖,横,提,点2,点,点,点,横,撇,捺,点
黛	撇,竖,横,斜钩|卧钩,点,竖,横折,点,撇,横,竖,横,横,点2,点,点,点
黜	竖,横折,点,撇,横,竖,横,提,点2,点,点,点,竖弯,竖,竖,竖弯,竖
黝	竖,横折,点,撇,横,竖,横,提,点2,点,点,点,撇折,撇折,点,横折钩,撇
黟	竖,横折,点,撇,横,竖,横,提,点2,点,点,点,撇,横撇|横钩,点,撇,横撇|横钩,点
黠	竖,横折,点,撇,横,竖,横,提,点2,点,点,点,横,竖,横,竖,横折,横
黡	
黢	竖,横折,点,撇,横,竖,横,提,点2,点,点,点,撇折,点,撇,点,撇,横撇|横钩,捺
黥	竖,横折,点,撇,横,竖,横,提,点2,点,点,点,点,横,竖,横折,横,竖钩,撇,点
黧	撇,横,竖,撇,点,撇,横折钩,撇,竖,横折,点,撇,横,竖,横,横,点2,点,点,点
黩	竖,横折,点,撇,横,竖,横,提,点2,点,点,点,横,竖,横撇|横钩,点,点,横,撇,点
黪	竖,横折,点,撇,横,竖,横,提,点2,点,点,点,撇折,点,横,撇,捺,撇,撇,撇
黯	竖,横折,点,撇,横,竖,横,提,点2,点,点,点,点,横,点,撇,横,竖,横折,横,横
黹	竖,竖,点,撇,横,点,撇,竖,横折钩,竖,撇,点
黻	竖,竖,点,撇,横,点,撇,竖,横折钩,竖,撇,点,横,撇,横撇|横钩,捺,点
黼	竖,竖,点,撇,横,点,撇,竖,横折钩,竖,撇,点,横,竖,横折钩,横,横,竖,点
黾	竖,横折,横,竖,横折,横,横,竖弯钩
鼋	横,横,撇,竖弯钩,竖,横折,横,竖,横折,横,横,竖弯钩
鼍	竖,横折,横,竖,横折,横,竖,横折,横,竖,横,横,竖,横折,横,竖,横折,横,横,竖弯钩
鼎	竖,横折,横,横,横,竖折撇|竖折折,横,撇,竖,横,竖,横折
鼐	横折折折钩|横撇弯钩,撇,竖,横折,横,横,横,竖折撇|竖折折,横,撇,竖,横,竖,横折
鼒	
鼓	横,竖,横,竖,横折,横,点,撇,提,横,竖,横撇|横钩,捺
鼗	撇,点,提,竖弯钩,撇,点,横,竖,横,竖,横折,横,点,撇,提,横,竖,横撇|横钩,捺
鼙	横,竖,横,竖,横折,横,点,撇,提,横,竖,横撇|横钩,捺,撇,竖,横折,横,横,撇,横,竖
鼠	撇,竖,横,横折,横,横,竖提,点,点,竖提,点,点,斜钩|卧钩
鼢	撇,竖,横,横折,横,横,竖提,点,点,竖提,点,点,斜钩|卧钩,撇,捺,横折钩,撇
鼩	
鼫	
鼬	撇,竖,横,横折,横,横,竖提,点,点,竖提,点,点,斜钩|卧钩,竖,横折,横,竖,横
鼯	撇,竖,横,横折,横,横,竖提,点,点,竖提,点,点,斜钩|卧钩,横,竖,横折,横,竖,横折,横
鼱	
鼷	撇,竖,横,横折,横,横,竖提,点,点,竖提,点,点,斜钩|卧钩,撇,点,点,撇,撇折,撇折,点,横,撇,捺
鼹	撇,竖,横,横折,横,横,竖提,点,点,竖提,点,点,斜钩|卧钩,竖,横折,横,横,点,点2,横撇|横钩,撇点,撇,横
鼻	撇,竖,横折,横,横,横,竖,横折,横,竖,横,横,撇,竖
鼽	撇,竖,横折,横,横,横,竖,横折,横,竖,横,横,撇,竖,撇,横斜钩
鼾	撇,竖,横折,横,横,横,竖,横折,横,竖,横,横,撇,竖,横,横,竖
齁	
齇	撇,竖,横折,横,横,横,竖,横折,横,竖,横,横,撇,竖,竖,横,横撇|横钩,撇,横,竖弯钩,竖,横折,横,横,横
齉	撇,竖,横折,横,横,横,竖,横折,横,竖,横,横,撇,竖,横,竖,横折,横,竖,点2,横撇|横钩,竖,横折,横,竖,横折,横,横,横,竖,竖,横,撇,竖提,撇,捺
齐	点,横,撇,捺,撇,竖
齑	点,横,撇,捺,撇,竖,竖,横,横,横,竖,横,横,横,横
齿	竖,横,竖,横,撇,点,竖弯,竖
龀	竖,横,竖,横,撇,点,竖弯,竖,撇,竖弯钩
龁	
龂	
龃	竖,横,竖,横,撇,点,竖弯,竖,竖,横折,横,横,横
龄	竖,横,竖,横,撇,点,竖弯,竖,撇,捺,点,横撇|横钩,点
龅	竖,横,竖,横,撇,点,竖弯,竖,撇,横折钩,横折,横,竖弯钩
龆	竖,横,竖,横,撇,点,竖弯,竖,横折钩,撇,竖,横折,横
龇	竖,横,竖,横,撇,点,竖弯,竖,竖,横,竖,提,撇,竖弯钩
龈	竖,横,竖,横,撇,点,竖弯,竖,横折,横,横,竖提,撇,捺
龉	竖,横,竖,横,撇,点,竖弯,竖,横,竖,横折,横,竖,横折,横
龊	竖,横,竖,横,撇,点,竖弯,竖,竖,横折,横,竖,横,撇,捺
龋	竖,横,竖,横,撇,点,竖弯,竖,撇,竖,横折,横,竖,横折钩,竖,提,点
龌	竖,横,竖,横,撇,点,竖弯,竖,横折,横,撇,横,撇折,点,横,竖,横
龙	横,撇,竖弯钩,撇,点
龚	横,撇,竖弯钩,撇,点,横,竖,竖,横,撇,点
龛	撇,捺,横,竖,横折,横,横,撇,竖弯钩,撇,点
龟	撇,横撇|横钩,竖,横折,横,横,竖弯钩
龠	撇,捺,横,竖,横折,横,竖,横折,横,竖,横折,横,竖,横折钩,横,竖,竖
龢	撇,点,横,竖,横折,横,竖,横折,横,竖,横折,横,竖,横折钩,横,竖,竖,撇,横,竖,撇,捺
鿍	
鿎	
鿏	
㑇	
㑊	
㕮	
㘎	
㙍	
㙘	
㙦	
㛃	
㛚	
㛹	
㟃	
㠇	
㠓	
㤘	
㥄	
㧐	
㧑	
㧟	
㫰	
㬊	
㬎	
㬚	
㭎	
㭕	
㮾	
㰀	
㳇	
㳘	
㳚	
㴔	
㵐	
㶲	
㸆	
㸌	
㺄	
㻬	
㽏	
㿠	
䁖	
䂮	
䃅	
䃎	
䅟	
䌹	
䎃	
䎖	
䏝	
䏡	
䏲	
䐃	
䓖	
䓛	
䓨	
䓫	
䓬	
䗖	
䗛	
䗪	
䗴	
䜣	
䝙	
䢺	
䢼	
䣘	
䥽	
䦃	
䲟	
䲠	
䲢	
䴓	
䴔	
䴕	
䴖	
䴗	
䴘	
䴙	
䶮	
𠅤	,
𠙶	,
𠳐	,
𡎚	,
𡐓	,
𣗋	,
𣲗	,
𣲘	,
𣸣	,
𤧛	,
𤩽	,
𤫉	,
𥔲	,
𥕢	,
𥖨	,
𥻗	,
𦈡	,
𦒍	,
𦙶	,
𦝼	,
𦭜	,
𦰡	,
𧿹	,
𨐈	,
𨙸	,
𨚕	,
𨟠	,
𨭉	,
𨱇	,
𨱏	,
𨱑	,
𨱔	,
𨺙	,
𩽾	,
𩾃	,
𩾌	,
𪟝	,
𪣻	,
𪤗	,
𪨰	,
𪨶	,
𪩘	,
𪾢	,
𫄧	,
𫄨	,
𫄷	,
𫄸	,
𫇭	,
𫌀	,
𫍣	,
𫍯	,
𫍲	,
𫍽	,
𫐄	,
𫐐	,
𫐓	,
𫑡	,
𫓧	,
𫓯	,
𫓶	,
𫓹	,
𫔍	,
𫔎	,
𫔶	,
𫖮	,
𫖯	,
𫖳	,
𫗧	,
𫗴	,
𫘜	,
𫘝	,
𫘦	,
𫘧	,
𫘨	,
𫘪	,
𫘬	,
𫚕	,
𫚖	,
𫚭	,
𫛭	,
𫞩	,
𫟅	,
𫟦	,
𫟹	,
𫟼	,
𫠆	,
𫠊	,
𫠜	,
𫢸	,
𫫇	,
𫭟	,
𫭢	,
𫭼	,
𫮃	,
𫰛	,
𫵷	,
𫶇	,
𫷷	,
𫸩	,
𬀩	,
𬀪	,
𬂩	,
𬃊	,
𬇕	,
𬇙	,
𬇹	,
𬉼	,
𬊈	,
𬊤	,
𬌗	,
𬍛	,
𬍡	,
𬍤	,
𬒈	,
𬒔	,
𬒗	,
𬕂	,
𬘓	,
𬘘	,
𬘡	,
𬘩	,
𬘫	,
𬘬	,
𬘭	,
𬘯	,
𬙂	,
𬙊	,
𬙋	,
𬜬	,
𬜯	,
𬞟	,
𬟁	,
𬟽	,
𬣙	,
𬣞	,
𬣡	,
𬣳	,
𬤇	,
𬤊	,
𬤝	,
𬨂	,
𬨎	,
𬩽	,
𬪩	,
𬬩	,
𬬭	,
𬬮	,
𬬱	,
𬬸	,
𬬹	,
𬬻	,
𬬿	,
𬭁	,
𬭊	,
𬭎	,
𬭚	,
𬭛	,
𬭤	,
𬭩	,
𬭬	,
𬭯	,
𬭳	,
𬭶	,
𬭸	,
𬭼	,
𬮱	,
𬮿	,
𬯀	,
𬯎	,
𬱖	,
𬱟	,
𬳵	,
𬳶	,
𬳽	,
𬳿	,
𬴂	,
𬴃	,
𬴊	,
𬶋	,
𬶍	,
𬶏	,
𬶐	,
𬶟	,
𬶠	,
𬶨	,
𬶭	,
𬶮	,
𬷕	,
𬸘	,
𬸚	,
𬸣	,
𬸦	,
𬸪	,
𬹼	,
𬺈	,
𬺓	,
